BM;BUDIMIR ZIVKO - STRANKA PRAVDE I POVJERENJA;COVIC DRAGAN - HDZ BIH - HRVATSKA DEMOKRATSKA ZAJEDNICA BOSNE I HERCEGOVINE;POPOVIC ANTO - DEMOKRATSKA FRONTA-ZELJKO KOMSIC;RAGUZ MARTIN - HDZ 1990 HRVATSKA DEMOKRATSKA ZAJEDNICA;Ukupno
001A000;0;0;0;0;0
001A001;7;2;27;10;46
001A002;8;2;34;12;56
001A003;19;1;21;4;45
001A004;14;1;17;4;36
001A005;17;1;27;7;52
001A006;25;0;39;11;75
001A007;6;1;16;0;23
001A008A;17;1;20;0;38
001A008B;5;0;7;0;12
001A008C;3;0;9;1;13
001A009A;7;0;12;0;19
001A009B;30;2;27;3;62
001A010;8;3;13;7;31
001A011;94;2;7;1;104
001A012A;6;3;18;3;30
001A012B;10;3;6;2;21
001A013;4;6;32;2;44
001A014A;42;4;17;1;64
001A014B;11;3;3;0;17
001A015A;22;4;13;0;39
001A015B;17;1;13;4;35
001A016A;18;6;11;2;37
001A016B;22;0;9;5;36
001A017;36;4;10;1;51
001A018;23;2;6;1;32
001A019;12;0;5;1;18
001A020;20;3;8;1;32
001A021;46;2;22;0;70
001A022;9;2;7;0;18
001A023;14;5;16;4;39
001A024;15;1;25;5;46
001A025;3;4;20;0;27
001A026;4;0;13;4;21
001A027A;27;1;2;0;30
001A027B;58;9;11;3;81
001A028;21;6;6;2;35
001A029A;38;5;20;3;66
001A029B;22;0;12;1;35
001A030;50;3;8;1;62
001A031A;18;1;6;0;25
001A031B;11;0;0;0;11
001A032;26;0;17;0;43
001A033;86;3;9;0;98
001A034;66;2;13;1;82
001A035;28;3;2;1;34
001A036;17;0;9;1;27
001A037;11;1;3;1;16
001A038;17;3;24;7;51
001A039;19;2;23;1;45
001A040;29;11;9;0;49
001A041;22;4;27;8;61
001A042;25;2;11;1;39
001A043;17;1;14;0;32
001A044;10;1;19;9;39
001A045;23;19;9;2;53
001A046;38;3;11;2;54
001A047;19;0;16;2;37
001A048;1;0;5;0;6
001A049;26;0;5;0;31
001A050;23;2;12;2;39
001A051;11;4;31;7;53
001A052;21;4;22;3;50
001A053;15;0;23;11;49
001A054;11;1;8;0;20
002A000;0;0;0;0;0
002A001;6;2;87;17;112
002A002;1;2;63;1;67
002A003;11;2;77;13;103
002A004;8;1;121;15;145
002A005;7;3;7;4;21
002A006;0;0;48;1;49
002A007;5;0;65;18;88
002A008A;3;0;32;6;41
002A008B;5;1;32;0;38
002A009;1;0;37;7;45
002A010;0;1;21;0;22
002A011;20;5;21;3;49
002A012;24;4;33;1;62
002A013;6;0;21;5;32
002A014;38;2;11;0;51
002A015;10;1;12;1;24
002A016;7;0;17;1;25
002A017;1;0;10;0;11
002A018A;0;0;31;5;36
002A018B;0;0;32;6;38
002A019;0;1;4;2;7
002A020A;0;2;35;3;40
002A020B;0;0;5;0;5
002A021A;0;0;6;0;6
002A021B;0;0;9;2;11
002A022A;2;3;24;1;30
002A022B;0;1;28;2;31
002A023A;1;2;30;0;33
002A023B;2;0;15;0;17
002A024;0;3;27;2;32
002A025;0;0;5;0;5
002A026;1;0;6;1;8
002A027A;2;0;23;6;31
002A027B;2;0;14;3;19
002A028A;1;0;28;0;29
002A028B;0;1;24;0;25
002A029;0;0;10;1;11
002A030;12;0;23;6;41
002A031A;22;3;25;3;53
002A031B;9;0;11;0;20
002A032;0;2;11;2;15
002A033A;17;0;7;4;28
002A033B;8;0;1;7;16
002A033C;6;0;8;3;17
002A034;0;0;0;2;2
002A035A;3;0;3;0;6
002A035B;1;1;7;6;15
002A035C;0;0;2;4;6
002A036;2;1;3;4;10
002A037;10;1;2;0;13
002A038;2;0;2;0;4
002A039;2;2;3;1;8
002A040;0;0;5;2;7
002A041;1;0;1;0;2
002A042;2;1;1;4;8
002A043;0;0;1;0;1
002A044;18;2;0;9;29
002A045;4;0;3;0;7
002A046;30;4;3;2;39
002A047;2;1;1;2;6
002A048;3;5;13;0;21
002A049;0;1;0;2;3
002A050;7;1;6;17;31
002A051;4;2;1;2;9
002A052;45;2;6;3;56
002A053;23;1;3;8;35
002A054A;2;0;1;3;6
002A054B;10;2;4;4;20
002A054C;3;0;1;2;6
002A055;0;1;1;0;2
002A056A;0;0;1;2;3
002A056B;1;2;3;1;7
002A057A;3;0;1;0;4
002A057B;0;1;2;1;4
002A058A;12;1;4;1;18
002A058B;12;1;2;2;17
002A059;0;1;1;7;9
002A060;2;0;0;1;3
002A061;1;1;5;2;9
003A000;0;0;0;0;0
003A001A;3;1;6;2;12
003A001B;1;0;0;2;3
003A001C;2;1;3;0;6
003A002;3;1;3;5;12
003A003;2;3;2;10;17
003A004;3;12;4;19;38
003A005;6;4;2;17;29
003A006;3;2;4;28;37
003A007;9;0;0;27;36
003A008A;12;2;65;22;101
003A008B;4;3;52;18;77
003A009;5;2;34;13;54
003A010;1;4;29;11;45
003A011;1;6;51;27;85
003A012;3;57;16;106;182
003A013;21;69;14;60;164
003A014;0;26;0;24;50
003A015;3;1;64;31;99
003A016;4;18;52;28;102
003A017;4;0;52;16;72
003A018;4;3;42;11;60
003A019;4;8;62;28;102
003A020;1;3;46;15;65
003A021;2;1;74;15;92
003A022A;2;0;31;14;47
003A022B;3;8;42;15;68
003A023;2;3;64;25;94
003A024;3;4;59;25;91
003A025;0;4;92;25;121
003A026;4;7;43;17;71
003A027;2;6;49;19;76
003A028A;1;1;59;19;80
003A028B;2;5;43;12;62
003A029;1;4;45;18;68
003A030;2;60;3;57;122
003A031;2;0;74;20;96
003A032;5;5;63;16;89
003A033;1;0;33;13;47
003A034;5;0;32;13;50
003A035;2;0;65;10;77
003A036;3;0;50;19;72
003A037;0;2;37;13;52
003A038;2;1;69;11;83
003A039;0;1;53;5;59
003A040;2;0;41;1;44
003A041;1;0;18;4;23
003A042;0;0;30;6;36
003A043;3;0;22;3;28
003A044;0;0;58;5;63
003A045A;2;0;43;4;49
003A045B;1;1;37;6;45
003A046;1;1;35;13;50
003A047;6;1;17;5;29
003A048;0;1;26;14;41
003A049;3;1;63;8;75
003A050;2;4;42;8;56
003A051;2;2;30;6;40
003A052;4;0;104;5;113
003A053;4;2;62;4;72
003A054;5;20;39;32;96
003A055;2;1;23;9;35
003A056;2;2;48;4;56
003A057A;3;1;30;2;36
003A057B;1;0;19;1;21
003A058;0;0;12;1;13
003A059;7;17;1;1;26
003A060A;1;2;12;0;15
003A060B;0;1;12;0;13
003A061;1;0;9;0;10
003A062A;3;0;6;0;9
003A062B;0;0;9;2;11
003A063;0;0;14;1;15
003A064A;0;2;15;0;17
003A064B;0;0;6;0;6
003A065A;2;1;21;1;25
003A065B;0;0;9;2;11
003A065C;2;1;6;0;9
003A066;0;0;16;5;21
003A067;0;0;27;0;27
003A068;0;0;33;4;37
003A069;1;0;41;6;48
003A070;0;0;4;2;6
003A071;0;0;11;0;11
003A072A;0;0;24;3;27
003A072B;0;0;28;6;34
003A073;2;0;31;6;39
003A074;0;0;30;7;37
003A075;0;0;47;6;53
003A076;2;14;52;8;76
004A000;0;0;0;0;0
004A001;0;0;56;3;59
004A002;0;0;18;1;19
004A003;0;0;106;14;120
004A004;1;0;116;8;125
004A005;0;0;92;12;104
004A006;3;2;86;12;103
004A007;0;1;102;5;108
004A008A;1;1;107;4;113
004A008B;0;0;44;4;48
004A009;0;2;75;4;81
004A010;2;4;72;5;83
004A011;1;2;83;11;97
004A012;0;1;57;7;65
004A013;0;0;74;1;75
004A014A;0;0;7;0;7
004A014B;0;0;5;0;5
004A015A;1;0;6;1;8
004A015B;3;0;9;0;12
004A015C;0;0;5;1;6
004A016;1;0;5;1;7
004A017A;1;0;35;0;36
004A017B;0;0;19;0;19
004A018A;2;0;8;0;10
004A018B;0;1;16;1;18
004A019;5;17;0;3;25
004A020;0;0;34;0;34
004A021;0;0;74;0;74
004A022;1;1;72;6;80
004A023;0;0;40;1;41
004A024;2;0;66;9;77
004A025;1;2;39;11;53
004A026;2;0;67;2;71
004A034;0;1;9;1;11
004A035;0;0;35;4;39
004A036;1;0;73;1;75
005A000;0;0;0;0;0
005A001;1;0;47;0;48
005A002;0;0;22;0;22
005A003;0;0;34;0;34
005A004;0;0;22;0;22
005A005A;0;0;12;0;12
005A005B;0;0;19;2;21
005A006;0;0;17;0;17
005A007A;0;0;14;0;14
005A007B;0;0;7;0;7
005A008A;2;1;29;6;38
005A008B;1;0;22;0;23
005A009A;0;0;18;0;18
005A009B;0;1;11;1;13
005A010;0;3;8;0;11
005A011A;2;0;18;7;27
005A011B;3;1;8;0;12
005A012;2;1;22;2;27
005A013;0;0;30;0;30
005A014;0;0;43;3;46
005A015;0;0;33;2;35
017A000;0;0;0;0;0
017A001;2;85;1;146;234
017A002;0;0;27;49;76
017A003;2;2;27;41;72
017A004;20;39;22;78;159
017A005;3;101;0;91;195
017A006;16;151;0;112;279
017A007;5;59;3;110;177
017A008;11;138;4;52;205
017A009;11;180;2;57;250
017A010;4;0;38;44;86
017A011;1;8;50;47;106
017A012;4;15;42;30;91
017A013;6;18;51;46;121
017A014;21;79;1;47;148
017A015;15;76;0;191;282
017A016;2;75;1;76;154
017A017;5;92;0;94;191
017A018;3;42;0;161;206
017A019;17;139;11;102;269
017A020;13;82;2;154;251
017A021;8;35;1;34;78
017A022;2;19;36;20;77
020A000;0;0;0;0;0
020A001;24;103;0;103;230
020A002;29;141;0;88;258
020A003;28;126;0;110;264
020A004;17;158;0;39;214
020A005;7;54;1;73;135
020A006;15;82;0;111;208
020A007;6;80;0;80;166
022A000;0;0;0;0;0
022A001;10;41;38;64;153
022A002;8;66;25;65;164
022A003A;17;163;2;48;230
022A003B;16;154;1;73;244
022A004;8;143;1;131;283
022A005;22;197;0;61;280
022A006;19;141;1;244;405
022A007;11;120;0;242;373
022A008A;11;245;0;60;316
022A008B;14;164;2;74;254
022A009;17;194;0;51;262
022A010;5;166;1;62;234
022A011;9;283;1;70;363
022A012;1;187;2;70;260
022A013;16;163;8;33;220
022A014;24;139;6;39;208
022A015;11;81;2;68;162
022A016;8;196;2;86;292
022A017;3;169;5;52;229
022A018;6;141;4;79;230
022A019;18;137;2;141;298
022A020;10;203;8;36;257
022A021;15;61;3;48;127
022A022;7;210;5;76;298
022A023;7;249;2;77;335
025A000;0;0;0;0;0
025A001;0;0;9;6;15
025A002;1;0;6;3;10
025A003A;1;0;2;0;3
025A003B;0;0;1;1;2
025A004;1;0;5;1;7
025A005A;1;1;6;6;14
025A005B;5;1;0;6;12
025A006A;0;1;0;3;4
025A006B;1;0;2;2;5
025A007A;1;1;0;0;2
025A007B;1;0;2;0;3
025A008A;13;2;8;12;35
025A008B;2;0;4;2;8
025A009A;2;0;5;7;14
025A009B;1;1;2;9;13
025A010;0;1;3;0;4
025A011;8;1;3;10;22
025A012;15;0;4;13;32
025A013A;13;2;1;9;25
025A013B;8;2;3;0;13
025A013C;46;0;4;2;52
025A013D;16;1;2;5;24
025A014;29;0;1;4;34
025A015;0;0;5;12;17
025A016;9;0;5;18;32
025A017;5;4;1;14;24
025A018;7;3;5;32;47
025A019;1;1;0;22;24
025A020;2;8;9;17;36
025A021;1;1;8;9;19
025A022;3;0;51;5;59
025A023;0;0;37;1;38
025A024;1;0;62;9;72
025A025;133;121;0;9;263
025A026;0;0;12;9;21
025A027;0;0;25;7;32
025A028;2;0;31;15;48
025A029;8;2;85;20;115
025A030;3;8;72;34;117
025A031;3;4;134;27;168
025A032;1;1;69;23;94
025A033;12;0;65;5;82
025A034;6;0;47;8;61
025A035;2;0;55;20;77
025A036;1;0;56;13;70
025A037;5;9;90;35;139
025A038;2;1;59;6;68
025A039;204;218;30;4;456
025A040;2;0;13;2;17
025A041;31;42;13;18;104
025A042;0;0;4;0;4
025A043;5;0;30;4;39
025A044;2;1;57;5;65
030A000;0;0;0;0;0
030A001;8;15;35;8;66
030A002;3;6;62;15;86
030A003;12;22;1;1;36
030A004;6;11;0;4;21
030A005;38;8;1;0;47
030A006;8;14;2;1;25
030A007;5;8;0;1;14
030A008;4;0;9;4;17
030A009;1;7;0;0;8
030A010;6;3;1;0;10
030A011;3;1;0;1;5
030A012;21;21;34;8;84
030A013;7;2;57;2;68
030A014;2;5;58;11;76
030A015;0;5;31;6;42
032A000;0;0;0;0;0
032A001;3;1;45;4;53
032A002;0;0;62;8;70
032A003;1;5;14;6;26
032A004;0;1;7;4;12
032A005;1;0;45;12;58
032A006;0;1;49;2;52
032A007;0;1;41;8;50
032A008;1;0;59;7;67
032A009;2;4;41;4;51
032A010;0;0;58;7;65
032A011;0;0;40;4;44
032A012;0;0;34;4;38
032A013;1;4;45;0;50
032A014;0;0;68;2;70
032A015;3;3;73;3;82
032A016;2;4;29;5;40
032A017;0;0;21;5;26
032A018;0;2;12;0;14
032A019;0;0;80;5;85
032A020;4;0;60;4;68
032A021;0;0;44;0;44
032A022;0;0;14;0;14
032A023;2;0;23;1;26
032A024;1;0;10;0;11
032A025;0;0;17;0;17
032A026;0;0;39;0;39
032A027;3;30;4;2;39
032A028;0;0;21;1;22
032A029;0;0;23;0;23
032A030;1;3;17;1;22
032A031;0;1;24;1;26
032A032A;0;0;12;1;13
032A032B;0;0;33;4;37
032A033;2;0;25;7;34
032A034;2;1;44;8;55
032A035;2;4;9;4;19
032A036;3;0;53;9;65
032A037;0;3;57;4;64
032A038;0;1;63;4;68
032A039;0;0;2;0;2
032A040;0;0;8;0;8
032A041;0;1;50;10;61
032A042;0;0;45;6;51
032A043;0;3;16;1;20
032A044;0;0;22;3;25
032A045;0;0;12;3;15
032A046;0;0;41;9;50
032A047;0;1;19;0;20
032A048;0;0;28;7;35
032A049;0;12;15;7;34
036A000;0;0;0;0;0
036A001A;1;1;66;19;87
036A001B;0;0;29;0;29
036A001C;0;2;53;26;81
036A001D;0;0;140;24;164
036A001E;0;0;47;16;63
036A001F;0;0;47;7;54
036A002;2;3;48;10;63
036A003A;0;0;26;8;34
036A003B;0;1;63;35;99
036A003C;0;1;34;8;43
036A004A;2;1;52;14;69
036A004B;1;0;28;17;46
036A005A;0;0;26;4;30
036A005B;0;0;23;4;27
037A001;0;0;59;9;68
037A002;1;0;52;6;59
037A003;5;1;115;22;143
037A004;3;1;91;15;110
037A005;1;0;72;26;99
037A006;1;2;53;14;70
039A000;0;0;0;0;0
039A001;0;0;76;22;98
039A002;0;40;29;15;84
039A003;3;1;60;15;79
039A004A;0;1;27;0;28
039A004B;0;0;16;2;18
039A005A;8;1;21;3;33
039A005B;4;0;29;5;38
039A006;0;1;27;3;31
039A007;3;21;75;49;148
039A008;0;5;76;31;112
039A009;0;34;41;18;93
039A010A;1;2;41;8;52
039A010B;0;0;63;2;65
039A011;1;1;32;7;41
039A012A;2;13;58;29;102
039A012B;2;0;77;16;95
039A013A;17;0;43;12;72
039A013B;4;0;17;7;28
039A014;2;0;82;19;103
039A015;0;2;46;22;70
039A016A;0;8;7;5;20
039A016B;1;2;15;12;30
039A017A;2;0;8;7;17
039A017B;0;0;19;7;26
039A018;3;3;46;15;67
039A019A;0;0;24;9;33
039A019B;1;0;30;14;45
039A020;0;0;17;12;29
039A021A;0;5;27;2;34
039A021B;0;10;22;10;42
039A022A;2;0;61;16;79
039A022B;0;0;18;2;20
039A022C;1;3;38;21;63
039A022D;2;0;9;4;15
039A023;2;10;47;34;93
039A024A;1;0;98;31;130
039A024B;1;0;53;8;62
039A024C;2;0;25;7;34
039A025;2;0;91;52;145
039A026;2;3;102;50;157
039A027;1;1;58;28;88
039A028A;0;0;74;38;112
039A028B;1;4;43;16;64
039A029;2;2;73;16;93
039A030;0;0;43;12;55
039A031A;1;0;8;3;12
039A031B;3;2;21;6;32
039A032A;1;2;41;4;48
039A032B;0;1;29;3;33
039A033;4;10;52;20;86
039A034;2;0;24;2;28
039A035;0;3;23;11;37
039A036;4;4;75;50;133
039A037;1;4;68;53;126
039A038;0;0;12;0;12
042A000;0;0;0;0;0
042A001;6;5;81;13;105
042A002;8;8;86;27;129
042A003A;2;3;54;16;75
042A003B;3;3;69;18;93
042A004;1;5;51;19;76
042A005;0;0;41;4;45
042A006;4;1;56;2;63
042A007;3;66;0;5;74
042A008;3;9;52;6;70
042A009;3;1;26;3;33
042A010A;1;6;54;4;65
042A010B;4;6;25;7;42
042A011;3;0;3;5;11
042A012;1;0;30;4;35
042A013A;1;2;25;1;29
042A013B;2;0;21;2;25
042A014;1;2;11;1;15
042A015A;1;0;22;0;23
042A015B;0;0;35;1;36
042A016;2;10;24;10;46
042A017;9;187;1;10;207
042A018;0;0;29;3;32
042A019;2;6;16;1;25
042A020;3;34;20;13;70
042A021;0;3;23;2;28
042A022;3;0;22;3;28
042A023;2;1;61;19;83
042A024A;0;1;24;3;28
042A024B;0;0;23;2;25
042A025;0;0;14;1;15
042A026;4;152;9;20;185
042A027;0;1;32;9;42
044A000;0;0;0;0;0
044A001;4;1;29;5;39
044A002;5;1;59;10;75
044A003;1;1;10;0;12
044A004;0;1;27;8;36
044A005;1;1;25;4;31
044A006;2;0;40;8;50
044A007;0;0;17;10;27
044A008;1;0;89;27;117
044A009;1;1;3;49;54
044A010;5;2;3;42;52
044A011;0;0;1;36;37
044A012;1;1;4;23;29
044A013;1;0;1;25;27
044A014;0;1;3;10;14
044A015;2;0;2;21;25
044A016;0;2;3;16;21
044A017;4;0;5;46;55
044A018;1;1;2;56;60
044A019;1;1;3;8;13
044A020;1;0;3;4;8
044A021;2;0;3;20;25
044A022;5;2;5;4;16
044A023;1;0;1;1;3
044A024;0;2;4;1;7
044A025;2;0;71;8;81
044A026;0;0;39;6;45
044A027;3;1;27;11;42
044A028;1;0;68;16;85
044A029A;4;0;172;17;193
044A029B;1;0;117;8;126
044A030;0;0;29;2;31
044A031;0;1;33;2;36
044A032A;0;0;39;1;40
044A032B;0;0;44;0;44
044A033;2;0;86;6;94
044A034;0;0;69;13;82
044A035;0;0;65;8;73
044A036;3;0;67;18;88
044A037;1;0;38;4;43
044A038;0;0;52;10;62
044A039A;5;0;66;13;84
044A039B;9;0;72;13;94
044A039C;3;1;38;5;47
044A040;0;0;17;1;18
044A041;0;0;42;0;42
044A042;2;0;54;25;81
044A043;0;0;32;23;55
044A044;1;0;56;1;58
044A045;2;0;66;15;83
044A046;3;0;67;10;80
044A047;2;1;29;4;36
044A048;1;0;30;4;35
044A049;3;0;66;2;71
044A050;0;1;34;5;40
044A051;4;0;13;10;27
044A052;1;0;9;1;11
044A053;1;0;9;1;11
044A054;0;0;6;0;6
044A055;2;0;80;26;108
044A056;3;1;88;41;133
044A057;4;0;54;34;92
044A058;1;1;46;6;54
047A000;0;0;0;0;0
047A001A;2;39;22;23;86
047A001B;5;79;11;53;148
047A002;6;38;37;21;102
047A003;3;4;87;33;127
047A004;4;4;107;34;149
047A005;4;4;96;9;113
047A006;5;11;104;25;145
047A007;4;1;74;22;101
047A008;1;6;108;19;134
047A009A;1;0;58;2;61
047A009B;0;0;34;7;41
047A010;4;0;77;8;89
047A011;0;0;83;4;87
047A012;0;0;41;2;43
047A013;1;1;49;6;57
047A014;4;0;63;8;75
047A015;1;0;27;0;28
047A016A;4;2;30;5;41
047A016B;1;0;39;3;43
047A016C;0;1;24;3;28
047A016D;0;0;24;5;29
047A017;0;2;23;1;26
047A018A;1;1;72;2;76
047A018B;0;0;34;3;37
047A018C;0;2;59;5;66
047A018D;1;1;21;2;25
047A019A;0;0;51;8;59
047A019B;2;0;70;6;78
047A019C;0;1;48;2;51
047A020;0;0;83;6;89
047A021;1;1;64;8;74
047A022;1;0;65;12;78
047A023A;2;1;59;4;66
047A023B;0;0;36;1;37
047A024A;1;0;90;3;94
047A024B;3;0;64;4;71
047A025;0;0;37;2;39
047A026;1;0;53;1;55
047A027A;0;1;62;3;66
047A027B;0;1;92;1;94
047A027C;0;0;18;1;19
047A027D;0;0;48;4;52
047A028;1;0;85;1;87
047A029;0;0;39;3;42
047A030;0;0;47;6;53
047A031;0;0;84;6;90
047A032;6;18;26;33;83
047A033;2;0;13;0;15
047A034;1;1;0;0;2
047A035;0;8;0;1;9
047A036;0;16;0;0;16
047A037;3;4;87;26;120
047A038;1;0;44;9;54
047A039;2;0;64;1;67
047A040;4;3;96;23;126
047A041;2;7;89;27;125
047A042;0;0;23;1;24
047A043;0;0;24;3;27
047A044A;2;1;30;6;39
047A044B;0;0;47;1;48
047A045;1;0;63;7;71
047A046;0;1;72;21;94
047A047;1;0;72;19;92
049A000;0;0;0;0;0
049A001;0;1;40;0;41
049A002;1;0;3;0;4
049A003A;1;2;50;0;53
049A003B;0;0;31;11;42
049A004;7;0;38;8;53
049A005;9;21;40;15;85
049A006;4;0;33;3;40
049A007;1;0;51;3;55
049A008A;2;4;61;21;88
049A008B;4;1;32;16;53
049A009;1;0;75;10;86
049A010;1;0;21;1;23
049A011;0;0;20;0;20
049A012A;5;4;26;5;40
049A012B;2;5;6;1;14
049A013;0;1;67;5;73
049A014;98;137;3;16;254
049A015;7;0;58;5;70
049A016;6;0;43;7;56
049A017;3;0;29;0;32
049A018A;0;1;57;9;67
049A018B;1;0;22;7;30
049A019;24;1;80;31;136
049A020;4;0;60;15;79
049A021;1;0;23;4;28
049A022;8;0;75;33;116
049A023;8;2;49;18;77
049A024;5;1;61;13;80
049A025;4;0;89;21;114
049A026;0;0;15;0;15
049A027;7;0;38;2;47
049A028;1;0;51;1;53
049A029;7;2;88;0;97
049A030;1;2;39;5;47
049A031;5;0;49;4;58
049A032;1;0;25;0;26
049A033;0;0;7;0;7
049A034;1;1;11;1;14
049A035;0;0;28;0;28
049A036;1;0;27;1;29
049A037;2;1;66;11;80
049A038;0;0;12;0;12
049A039;107;74;1;14;196
049A040;1;0;33;3;37
049A041;0;1;10;0;11
049A042;0;0;43;1;44
049A043;3;1;43;13;60
049A044;0;0;30;6;36
049A045;0;0;49;0;49
049A046;1;1;29;14;45
049A047;0;0;32;2;34
049A048A;2;0;39;1;42
049A048B;0;0;21;1;22
049A049;7;2;66;14;89
049A050A;1;0;22;2;25
049A050B;1;3;11;1;16
049A051;34;127;0;9;170
049A052;3;4;17;3;27
049A053;0;1;25;2;28
049A054;6;3;67;28;104
049A055;1;4;83;13;101
049A056;4;0;22;1;27
049A057;0;1;11;0;12
049A058;0;0;4;2;6
049A059;0;0;0;0;0
049A060;2;0;22;2;26
049A061;8;33;1;11;53
049A062;4;0;44;19;67
050A000;0;0;0;0;0
050A001;2;7;78;34;121
050A002;3;2;63;44;112
050A003;0;2;60;22;84
050A004;3;23;66;56;148
050A005;1;5;79;45;130
050A006;4;16;83;48;151
050A007;2;10;97;41;150
050A008;1;10;60;43;114
050A009;1;2;29;25;57
050A010;4;10;64;74;152
050A011;1;11;47;61;120
050A012;2;11;50;57;120
050A013;6;10;68;28;112
050A014;3;11;78;68;160
050A015;2;0;56;47;105
050A016;5;9;61;60;135
050A017;2;4;39;38;83
050A018;4;4;38;41;87
050A019;7;60;11;34;112
050A020;3;41;51;51;146
050A021;5;70;8;50;133
050A022;1;5;60;45;111
050A023;0;1;61;10;72
050A024;1;1;46;17;65
050A025;9;103;17;57;186
050A026;8;5;12;28;53
050A027;2;60;11;25;98
050A028;0;0;22;5;27
050A029;2;1;38;4;45
050A030;2;1;60;6;69
050A031;1;38;2;19;60
050A032;0;0;29;16;45
050A033;0;0;40;4;44
050A034;0;0;32;8;40
050A035;3;27;2;14;46
050A036;1;0;29;11;41
050A037;0;8;55;25;88
050A038;3;35;13;52;103
050A039;8;105;13;42;168
050A040;6;63;14;48;131
050A041;2;40;29;39;110
050A042;2;0;46;23;71
050A043;1;1;58;35;95
050A044;5;49;40;36;130
050A045;4;24;41;16;85
050A046;0;11;48;13;72
050A047;1;0;42;16;59
050A048;0;1;42;26;69
050A049;1;35;26;52;114
050A050;2;2;27;18;49
050A051;9;40;22;38;109
050A052;6;37;53;17;113
050A053;8;81;6;34;129
050A054;7;245;10;79;341
050A055;3;80;6;44;133
050A056;0;0;51;3;54
050A057;5;5;16;0;26
050A058;4;96;13;45;158
050A059;5;3;44;31;83
050A060;2;10;46;26;84
050A061;2;10;62;25;99
050A062;2;8;53;22;85
050A063;0;15;47;21;83
050A064;3;8;50;28;89
050A065;1;1;61;40;103
050A066;0;0;68;24;92
050A067;0;8;84;28;120
050A068;3;13;42;32;90
050A069;2;1;55;9;67
050A070;3;10;47;21;81
050A071;2;28;34;22;86
050A072;0;1;21;5;27
050A073;3;9;73;14;99
050A074;6;8;78;38;130
050A075;1;5;53;44;103
050A076;1;3;81;57;142
050A077;1;9;57;49;116
050A078;1;10;70;57;138
050A079;2;10;82;75;169
050A080;6;75;0;40;121
050A081;0;1;72;16;89
050A082;2;0;45;3;50
050A083;0;1;14;3;18
050A084;1;2;29;10;42
050A085;6;77;4;35;122
050A086;5;49;5;30;89
050A087;3;73;2;36;114
050A088;0;7;57;29;93
050A089;1;3;42;11;57
050A090;0;4;36;2;42
050A091;1;4;55;6;66
050A092;0;0;55;11;66
050A093;4;15;10;8;37
050A094;2;7;87;59;155
050A095;3;12;72;75;162
050A096;2;8;60;44;114
050A097;4;10;61;53;128
050A098;7;8;91;79;185
050A099;4;7;77;47;135
050A100;1;0;36;13;50
050A101;0;13;111;62;186
050A102;2;15;53;24;94
050A103;1;12;69;79;161
050A104;2;29;44;37;112
050A105;3;1;63;27;94
050A106A;0;1;78;17;96
050A106B;2;3;59;38;102
050A107;0;0;56;23;79
050A108;1;6;55;30;92
050A109;1;1;62;23;87
050A110;3;5;66;24;98
050A111;2;2;98;15;117
050A112;0;3;42;14;59
050A113;2;2;65;24;93
050A114;1;2;49;12;64
050A115;4;9;60;32;105
050A116;1;15;30;31;77
050A117;0;7;67;29;103
050A118;2;8;46;30;86
050A119;3;8;67;48;126
050A120;0;2;78;17;97
050A121;0;8;52;21;81
050A122;2;8;76;69;155
050A123;1;8;58;36;103
050A124;1;17;133;81;232
050A125;3;13;66;74;156
050A126;5;9;98;68;180
050A127;4;15;79;66;164
050A128;1;13;72;73;159
050A129;4;9;86;76;175
050A130;6;4;47;79;136
050A131;1;12;57;67;137
050A132;5;9;61;64;139
050A133;3;0;91;13;107
050A134;3;6;52;22;83
050A135;0;1;28;3;32
050A136;0;0;30;4;34
050A137;3;1;74;17;95
050A138;2;4;53;7;66
050A139;1;2;85;36;124
050A140;1;0;63;31;95
050A141;0;2;63;41;106
050A142;4;13;76;89;182
050A143;2;5;45;52;104
050A144;2;12;57;88;159
050A145;3;8;87;84;182
050A146;0;2;91;43;136
050A147;2;8;76;62;148
050A148;4;1;76;35;116
050A149;1;2;22;21;46
050A150;1;4;72;34;111
050A151;2;1;73;42;118
050A152;0;12;92;25;129
052A000;0;0;0;0;0
052A001;1;2;56;7;66
052A002;1;3;77;14;95
052A003;0;0;48;10;58
052A004;1;1;22;1;25
052A005;3;0;12;4;19
052A006;0;1;27;0;28
052A007;0;2;7;0;9
052A008;0;1;4;3;8
052A009;1;1;19;0;21
052A010;0;1;12;3;16
052A011;0;1;6;4;11
052A012;105;268;0;9;382
052A013;0;0;25;7;32
052A014;2;1;43;6;52
052A015;0;2;41;5;48
052A016;0;1;37;1;39
055A001A;0;0;43;0;43
055A001B;1;0;20;3;24
055A001C;1;1;9;1;12
055A002A;0;0;14;2;16
055A002B;1;0;20;3;24
055A003;1;0;61;0;62
055A004;0;0;11;0;11
055A005;1;0;24;5;30
055A006;1;0;10;1;12
057A000;0;0;0;0;0
057A001;5;103;0;48;156
057A002;8;69;2;84;163
057A003;7;40;0;39;86
057A004;4;100;0;87;191
057A005;6;58;0;44;108
057A006;2;57;0;27;86
057A007;0;35;0;9;44
057A008;1;35;0;6;42
057A009;1;26;0;20;47
057A010;8;60;0;45;113
057A011;3;48;0;37;88
057A012;0;0;0;7;7
057A013;3;53;0;47;103
057A014;0;12;0;0;12
057A015;0;13;1;4;18
057A016;1;6;0;12;19
059A000;0;0;0;0;0
059A001;0;2;97;8;107
059A002;1;1;70;12;84
059A003;0;1;44;7;52
059A004;0;3;54;7;64
059A005;0;1;22;3;26
059A006;0;1;40;4;45
059A007A;0;0;18;0;18
059A007B;0;0;13;1;14
059A008;1;1;26;0;28
059A009;0;0;35;2;37
059A010A;0;1;14;1;16
059A010B;0;0;11;0;11
059A011;0;0;16;2;18
059A012;0;2;44;4;50
059A013;0;0;68;7;75
059A014;2;0;25;8;35
059A015;1;0;14;0;15
059A016;2;1;25;3;31
059A017;0;1;50;7;58
059A018;0;10;24;3;37
059A019;0;2;65;10;77
065A000;0;0;0;0;0
065A001;7;79;33;60;179
065A002;7;91;22;53;173
065A003;3;141;15;50;209
065A004;3;29;40;37;109
065A005;4;100;24;43;171
065A006;7;88;28;65;188
065A007;13;156;9;103;281
065A008;4;69;50;67;190
065A009;5;37;31;30;103
065A010;5;67;15;40;127
065A011;2;26;6;14;48
065A012A;9;2;29;10;50
065A012B;6;0;17;5;28
065A013;5;60;15;43;123
065A014;7;38;11;30;86
065A015;0;4;18;6;28
065A016;0;89;12;81;182
065A017;11;190;25;101;327
065A018;3;127;9;69;208
065A019;2;76;5;72;155
065A020;7;168;7;66;248
065A021;0;0;17;0;17
065A022;2;99;17;13;131
065A023;2;36;12;13;63
065A024;11;167;2;79;259
065A025;10;106;4;49;169
065A026;8;115;14;23;160
065A027;0;7;9;3;19
065A028;1;85;20;70;176
065A029;1;9;4;2;16
065A030;0;0;3;0;3
065A031;10;101;6;70;187
065A032;1;83;0;32;116
065A033;5;46;1;36;88
065A034;2;46;8;6;62
067A000;0;0;0;0;0
067A001;4;124;0;34;162
067A002;0;44;0;36;80
067A003;8;54;0;24;86
075A000;0;0;0;0;0
075A001;3;320;1;39;363
075A002;8;319;0;39;366
075A003;0;0;14;3;17
075A004;0;95;0;13;108
075A005;0;1;11;2;14
075A006;24;253;0;28;305
075A007;4;233;7;41;285
075A008;8;369;3;40;420
075A009;0;0;4;2;6
075A010;7;172;0;20;199
075A011;5;100;22;30;157
075A012;3;42;42;21;108
075A013;16;330;5;40;391
075A014;2;21;34;16;73
075A015;4;190;0;14;208
075A016;4;218;4;61;287
075A017;4;192;0;39;235
075A018;3;159;0;50;212
075A019;2;132;0;28;162
075A020;2;171;0;32;205
075A021;0;179;2;14;195
075A022;19;259;0;67;345
075A023A;0;1;30;2;33
075A023B;1;0;34;5;40
075A024A;11;80;9;19;119
075A024B;7;111;5;40;163
075A025;0;0;26;2;28
075A026;8;112;30;67;217
075A027;7;196;0;42;245
075A028;1;0;16;2;19
075A029;4;113;29;51;197
075A030;6;118;15;27;166
075A031;4;31;1;8;44
075A032;2;128;0;9;139
075A033;8;176;0;35;219
075A034;1;47;3;3;54
075A035;6;48;36;40;130
077A000;0;0;0;0;0
077A001;4;3;30;18;55
077A002;4;12;59;34;109
077A003;5;10;68;37;120
077A004;6;2;40;30;78
077A005;6;1;29;16;52
077A006A;5;9;90;41;145
077A006B;3;2;28;13;46
077A007;6;14;20;16;56
077A008;4;7;42;21;74
077A009;7;1;31;12;51
077A010;2;8;27;4;41
077A011;1;0;37;16;54
077A012;0;0;2;0;2
077A013;0;0;18;9;27
077A014;0;1;29;6;36
077A015;5;1;28;10;44
077A016;2;12;8;9;31
077A017;1;2;33;8;44
077A018;5;0;34;6;45
077A019;0;1;19;13;33
077A020;0;0;10;4;14
077A021;1;0;19;12;32
077A022;2;1;19;6;28
077A023;2;0;22;0;24
077A024;1;0;22;0;23
077A025;0;0;16;0;16
077A026;6;1;67;19;93
077A027A;1;0;40;7;48
077A027B;1;5;23;15;44
077A028;0;0;24;4;28
077A029;0;0;4;0;4
077A030;1;0;21;4;26
077A031;1;3;38;24;66
077A032;2;26;35;8;71
077A033;1;1;4;5;11
077A034;0;0;3;3;6
077A035;0;0;19;3;22
077A036;1;0;26;9;36
077A037;6;22;24;38;90
077A038;0;0;28;9;37
077A039;0;24;7;14;45
077A040;3;11;41;25;80
077A041;2;0;5;2;9
077A042;1;0;16;9;26
077A043;1;0;5;6;12
077A044;2;0;33;3;38
077A045;2;5;49;10;66
077A046;2;59;18;25;104
077A047;0;14;25;26;65
077A048;0;0;13;4;17
077A049;0;27;0;3;30
077A050;2;0;29;11;42
077A051;0;0;21;24;45
077A052;2;4;39;18;63
077A053;0;0;9;27;36
077A054;1;0;10;5;16
077A055;0;0;3;0;3
077A056;1;3;34;19;57
077A057;6;17;34;16;73
077A058;0;0;5;0;5
078A000;0;0;0;0;0
078A001;1;1;25;1;28
078A002;1;4;31;6;42
078A003;1;1;33;8;43
078A004;1;0;36;9;46
078A005;2;3;26;6;37
078A006;0;4;41;4;49
078A007;0;0;23;0;23
078A008;1;0;20;0;21
078A009;0;7;14;0;21
078A010;0;0;12;3;15
078A011A;0;0;10;0;10
078A011B;1;1;17;0;19
078A012A;0;1;18;1;20
078A012B;0;0;27;4;31
078A012C;0;0;15;5;20
078A013;1;0;58;9;68
078A014;0;0;4;0;4
078A015;4;1;25;3;33
078A016;0;1;14;3;18
078A017;0;0;30;2;32
078A018;0;0;4;0;4
078A019;0;0;37;0;37
078A020;0;0;32;3;35
078A021;0;0;18;0;18
078A022;0;0;5;0;5
078A023;0;0;29;1;30
078A024;1;4;38;5;48
078A025;1;0;33;1;35
078A026;0;0;28;2;30
078A027;0;0;18;0;18
078A028;0;6;38;3;47
078A029;0;0;26;2;28
078A030;0;0;4;0;4
078A031;0;5;32;8;45
078A032;1;0;5;0;6
079A000;0;0;0;0;0
079A001;1;0;9;1;11
079A002;1;0;18;2;21
079A003;5;0;27;0;32
079A004;3;0;7;5;15
079A005A;3;0;13;7;23
079A005B;3;0;6;8;17
079A006;1;0;12;1;14
079A007;1;0;18;9;28
079A008A;0;0;4;3;7
079A008B;1;0;11;2;14
079A009A;1;0;41;13;55
079A009B;3;0;29;19;51
079A010;1;0;18;7;26
079A011A;5;1;31;10;47
079A011B;0;0;23;10;33
079A012;1;0;20;2;23
079A013;3;0;41;19;63
079A014;0;0;48;12;60
079A015;2;1;48;17;68
079A016;1;0;44;7;52
079A017;6;1;35;4;46
079A018;2;2;57;15;76
079A019;1;5;48;16;70
079A020;0;0;26;0;26
079A021;3;0;29;3;35
079A022;7;0;44;7;58
079A023;4;0;22;0;26
079A024;2;0;36;1;39
079A025;3;0;33;5;41
079A026;1;5;35;13;54
079A027;2;30;50;18;100
079A028;1;0;28;7;36
079A029;3;0;26;12;41
079A030;5;113;31;36;185
079A031;2;18;35;16;71
079A032;4;20;25;10;59
079A033;1;3;36;24;64
079A034;0;0;57;6;63
079A035A;1;0;44;5;50
079A035B;0;1;32;5;38
079A036;1;0;51;9;61
079A037;0;0;79;21;100
079A038;0;0;41;11;52
079A039;2;2;52;14;70
079A040;1;0;62;8;71
079A041A;3;2;42;10;57
079A041B;1;0;51;5;57
079A042;6;62;14;51;133
079A043;0;0;21;8;29
079A044;1;12;38;15;66
079A045;0;1;27;11;39
079A046;2;0;27;6;35
079A047;2;0;47;6;55
079A048A;0;0;25;7;32
079A048B;0;0;25;2;27
079A049;2;1;18;10;31
079A050;6;70;46;25;147
079A051;5;30;61;26;122
079A052A;0;8;24;17;49
079A052B;10;9;42;11;72
079A052C;0;0;22;4;26
079A053;0;0;32;3;35
079A054;3;4;30;12;49
079A055;5;2;61;9;77
079A056A;10;0;45;6;61
079A056B;6;0;42;10;58
079A056C;12;1;37;14;64
079A057;8;1;39;9;57
079A058;1;3;23;7;34
079A059;2;7;33;19;61
079A060;0;0;44;11;55
079A061;4;24;71;25;124
079A062;6;8;46;31;91
079A063A;0;14;59;29;102
079A063B;3;11;42;16;72
079A064A;1;12;67;14;94
079A064B;1;18;36;21;76
079A065;0;17;51;13;81
079A066;5;3;38;21;67
079A067;3;14;53;28;98
079A068A;2;5;53;12;72
079A068B;1;4;25;10;40
079A069;5;30;35;29;99
079A070;6;12;54;39;111
079A071;2;19;45;19;85
080A000;0;0;0;0;0
080A001;2;0;47;4;53
080A002;0;0;44;11;55
080A003;0;0;57;6;63
080A004;0;0;38;8;46
080A005A;0;0;43;6;49
080A005B;0;0;20;3;23
080A006A;2;0;18;5;25
080A006B;0;1;21;1;23
080A007A;1;1;50;8;60
080A007B;0;1;46;4;51
080A007C;0;0;16;0;16
080A008;0;0;13;9;22
080A009A;0;0;35;4;39
080A009B;1;1;44;17;63
080A009C;0;0;32;3;35
080A010A;1;1;26;2;30
080A010B;0;0;16;6;22
080A011A;1;1;34;1;37
080A011B;1;0;28;5;34
080A011C;3;0;29;4;36
080A012A;1;0;36;3;40
080A012B;1;0;44;0;45
080A012C;1;0;16;2;19
080A013;0;2;0;0;2
080A014A;0;0;36;8;44
080A014B;5;0;21;1;27
080A014C;0;1;28;8;37
080A014D;0;0;17;1;18
080A015A;4;1;32;9;46
080A015B;0;0;16;6;22
080A015C;0;0;19;0;19
080A016A;0;0;33;7;40
080A016B;0;1;42;3;46
080A016C;0;0;38;7;45
080A016D;0;0;15;3;18
080A017A;1;1;45;21;68
080A017B;0;0;25;5;30
080A018A;0;0;23;0;23
080A018B;1;0;30;1;32
080A019;0;0;12;0;12
080A020;0;0;24;0;24
080A021;5;0;22;1;28
080A022;0;0;20;0;20
080A023A;0;0;25;4;29
080A023B;3;0;53;4;60
080A023C;0;0;24;0;24
080A024;0;2;18;2;22
080A025;0;0;1;0;1
080A026A;3;1;32;6;42
080A026B;0;1;19;2;22
080A027;1;1;34;1;37
082A000;0;0;0;0;0
082A001A;0;0;20;0;20
082A001B;1;1;30;0;32
082A002;0;0;111;3;114
082A003;0;0;57;0;57
082A004;0;0;33;2;35
082A005A;0;0;48;2;50
082A005B;0;0;37;0;37
082A005C;0;0;20;0;20
082A006;0;0;90;0;90
082A007A;0;1;44;0;45
082A007B;0;0;53;4;57
082A007C;0;0;14;0;14
082A008;0;0;51;3;54
082A009;1;0;60;13;74
082A010;0;6;0;0;6
084A000;0;0;0;0;0
084A001;7;47;0;19;73
084A002;1;17;0;9;27
084A003;2;30;0;6;38
084A004;3;10;0;4;17
084A005;4;92;0;33;129
084A006;0;102;0;0;102
085A000;0;0;0;0;0
085A001;5;176;18;60;259
085A002;6;172;4;46;228
085A003;4;55;2;14;75
085A004;5;17;3;6;31
085A005;3;11;0;1;15
085A006;4;10;0;4;18
085A007;1;4;0;6;11
085A008;1;14;0;3;18
085A009;5;66;4;15;90
089A000;0;0;0;0;0
089A001A;2;4;40;11;57
089A001B;0;1;35;12;48
089A002;1;0;30;6;37
089A003;1;0;73;14;88
089A004;2;1;51;18;72
089A005;1;1;49;15;66
089A006;1;1;90;11;103
089A007;0;0;59;14;73
089A008A;2;0;42;15;59
089A008B;2;0;38;15;55
089A009;0;0;11;3;14
089A010;0;1;36;2;39
089A011;0;0;19;2;21
089A012;0;0;32;12;44
089A013;0;0;44;1;45
089A014;2;1;58;17;78
089A015A;0;2;36;3;41
089A015B;0;0;21;7;28
089A016;2;2;33;5;42
091A000;0;0;0;0;0
091A001;1;3;16;9;29
091A002;0;6;18;4;28
091A003;0;0;10;0;10
091A004;0;0;24;4;28
091A005;0;1;48;13;62
091A006;4;6;21;14;45
091A007;1;204;0;49;254
091A008;0;0;15;2;17
091A009;1;0;26;4;31
091A010;0;0;44;8;52
091A011A;0;6;33;26;65
091A011B;0;0;27;12;39
091A012;2;17;18;10;47
091A013;7;153;1;147;308
091A014;7;188;0;55;250
091A015;2;69;24;7;102
091A016;2;79;4;104;189
091A017A;1;17;40;28;86
091A017B;1;17;22;27;67
091A018;3;16;48;32;99
091A019;10;126;12;92;240
091A020;6;42;55;45;148
091A021;1;22;46;56;125
091A022;7;26;56;41;130
091A023;2;30;78;78;188
091A024;5;38;62;74;179
091A025A;3;6;54;29;92
091A025B;2;10;29;29;70
091A026;2;17;38;30;87
091A027;1;1;43;25;70
091A028;0;2;61;17;80
091A029;2;39;33;14;88
091A030;1;20;57;35;113
091A031;13;346;0;97;456
091A032;7;241;1;136;385
091A033;3;110;0;23;136
091A034;6;247;0;133;386
091A035;9;171;0;64;244
091A036;0;106;0;54;160
091A037;1;26;21;11;59
091A038;5;139;1;73;218
091A039;0;13;10;10;33
091A040;1;5;46;17;69
091A041;1;96;0;18;115
091A042;2;21;8;13;44
091A043;0;35;50;52;137
091A044;0;2;16;2;20
091A045;1;2;12;2;17
091A046;1;0;6;1;8
091A047;0;0;5;0;5
091A048;1;1;7;0;9
091A049;3;0;16;0;19
091A050;0;1;34;0;35
091A051;4;22;46;26;98
091A052;1;60;41;27;129
091A053;1;6;21;13;41
091A054;3;112;33;50;198
091A055;6;7;20;7;40
091A056;0;51;37;29;117
091A057;0;1;2;4;7
091A058;1;0;19;3;23
091A059;6;22;48;63;139
091A060;1;56;25;73;155
091A061;0;4;28;7;39
091A062;2;125;3;26;156
091A063;2;34;8;17;61
091A064;0;1;13;3;17
091A065;0;3;11;4;18
091A066;1;10;33;24;68
091A067;0;16;53;56;125
091A068;3;104;0;24;131
093A000;0;0;0;0;0
093A001;1;0;17;8;26
093A002;1;4;26;15;46
093A003;3;3;35;1;42
093A004;0;0;14;2;16
093A005;0;1;4;1;6
093A006;4;19;77;79;179
093A007;0;5;40;29;74
093A008;1;5;46;31;83
093A009;6;12;70;51;139
093A010;0;7;73;50;130
093A011;6;13;59;36;114
093A012;2;14;57;37;110
093A013;2;17;71;64;154
093A014;4;29;53;64;150
093A015;2;11;82;84;179
093A016;1;18;85;62;166
093A017;7;8;79;51;145
093A018;3;11;59;38;111
093A019;4;10;57;42;113
093A020;1;3;63;47;114
093A021;3;21;50;27;101
093A022;2;10;76;66;154
093A023;6;12;55;47;120
093A024;5;21;76;61;163
093A025;3;9;62;38;112
093A026;3;12;58;41;114
093A027;2;10;67;39;118
093A028;7;105;24;109;245
093A029;1;0;60;10;71
093A030;1;0;17;5;23
093A031;1;4;80;18;103
093A032;0;6;38;24;68
093A033;4;1;62;9;76
093A034;1;1;32;2;36
093A035;1;4;36;12;53
093A036;1;0;34;9;44
093A037;2;4;35;9;50
093A038;3;9;69;41;122
093A039;2;13;84;47;146
093A040;0;5;67;26;98
093A041;0;0;53;27;80
093A042;0;8;42;30;80
093A043;1;10;44;28;83
093A044;0;2;36;10;48
093A045;0;0;40;4;44
093A046;0;0;4;0;4
093A047;0;0;37;4;41
093A048;0;5;24;14;43
093A049;2;19;24;34;79
093A050;8;9;87;58;162
093A051;5;11;59;72;147
093A052;4;9;48;34;95
093A053;1;1;13;5;20
093A054;0;0;24;13;37
093A055;3;26;83;65;177
093A056;4;11;71;53;139
093A057;2;7;60;60;129
093A058;4;0;52;17;73
093A059;0;0;65;13;78
093A060;4;11;61;46;122
093A061;1;2;50;24;77
093A062;1;15;62;80;158
093A063;5;12;66;27;110
093A064;1;10;69;52;132
093A065;3;8;35;55;101
093A066;9;19;42;42;112
093A067;4;8;53;25;90
093A068;7;4;68;51;130
093A069;3;6;64;39;112
093A070A;1;1;12;1;15
093A070B;1;0;10;3;14
093A071;1;1;30;3;35
093A072;1;2;60;19;82
093A073;4;15;55;48;122
093A074;0;0;4;0;4
093A075;8;96;9;60;173
093A076;0;6;7;14;27
093A077;0;0;8;3;11
093A078;1;56;25;28;110
093A079;0;1;35;4;40
093A080;0;9;68;33;110
093A081;8;8;58;54;128
093A082;0;0;17;0;17
093A083;1;0;3;0;4
093A084;0;0;10;1;11
093A085;2;21;70;57;150
093A086;2;18;66;53;139
093A087;5;14;57;53;129
093A088;3;15;62;43;123
093A089;1;10;52;58;121
093A090;2;1;32;17;52
093A091A;0;0;7;0;7
093A091B;2;0;8;1;11
093A092;0;2;33;10;45
093A093;2;2;65;10;79
093A094;0;0;14;0;14
093A095;4;8;56;29;97
093A096;1;0;44;11;56
093A097;1;17;23;15;56
093A098;0;0;12;0;12
093A099;3;11;51;32;97
093A100;1;6;38;48;93
093A101;3;7;52;12;74
093A102;0;2;39;4;45
093A103;3;0;59;26;88
093A104;1;4;43;15;63
093A105;3;18;40;43;104
093A106;4;3;64;32;103
093A107;2;18;35;42;97
093A108;3;38;29;52;122
093A109;4;1;66;31;102
093A110;0;5;22;21;48
093A111;3;2;39;26;70
093A112;0;0;18;8;26
093A113;4;3;55;72;134
093A114;6;9;70;49;134
093A115;1;14;74;38;127
093A116;6;11;54;9;80
093A117;2;7;41;28;78
093A118;2;3;26;28;59
093A119;0;2;58;5;65
093A120;4;3;54;2;63
093A121;1;2;39;6;48
093A122;0;0;11;0;11
093A123;1;4;34;21;60
093A124;1;0;10;5;16
093A125;0;0;1;0;1
093A126;0;0;2;0;2
093A127;0;0;29;3;32
093A128;7;9;52;28;96
093A129;0;4;23;12;39
093A130;1;5;15;11;32
093A131;3;6;55;23;87
093A132;1;0;25;2;28
093A133;2;2;56;30;90
093A134;5;5;35;24;69
093A135;5;2;35;53;95
093A136;2;3;49;32;86
094A000;0;0;0;0;0
094A001;0;2;19;12;33
094A002;0;0;26;1;27
094A003;1;1;18;3;23
094A004;0;0;24;1;25
094A005;7;32;87;48;174
094A006;4;72;4;22;102
094A007;1;0;35;13;49
094A008;3;85;17;35;140
094A009;3;15;59;39;116
094A010;0;0;18;2;20
094A011;1;0;12;1;14
094A012;4;9;71;22;106
094A013;1;0;67;7;75
094A014A;6;6;30;6;48
094A014B;2;4;20;4;30
094A015;0;7;62;28;97
094A016;2;1;38;10;51
094A017;0;0;11;1;12
094A018;2;9;40;2;53
094A019;0;0;15;1;16
094A020;1;1;32;13;47
094A021;10;72;24;57;163
094A022;3;17;62;20;102
094A023;0;0;10;2;12
094A024;5;53;0;40;98
094A025;1;1;7;2;11
094A026;0;0;12;1;13
094A027;0;0;18;3;21
094A028;1;0;31;4;36
094A029;6;51;6;18;81
094A030;0;1;55;11;67
094A031;1;0;24;4;29
094A032;4;7;14;10;35
094A033;0;0;3;3;6
094A034;0;0;9;0;9
094A035;0;2;53;10;65
094A036;0;0;15;1;16
094A037;0;5;15;5;25
094A038;3;44;5;22;74
094A039;1;1;37;5;44
094A040;0;3;41;9;53
094A041;0;19;63;30;112
094A042;0;0;31;4;35
094A043;1;20;45;22;88
094A044;0;0;5;0;5
094A045;0;2;22;21;45
094A046;5;1;68;5;79
094A047;0;17;34;16;67
094A048;0;0;32;15;47
094A049;2;10;40;17;69
094A050;1;4;58;11;74
094A051;0;7;21;16;44
094A052;4;12;15;5;36
094A053;0;7;52;18;77
094A054;1;0;50;9;60
094A055;0;0;6;4;10
094A056;0;8;41;11;60
094A057;1;2;25;13;41
094A058;3;12;8;14;37
095A000;0;0;0;0;0
095A001;8;63;49;61;181
095A002;13;32;63;71;179
095A003;3;31;31;34;99
095A004;7;47;64;56;174
095A005;6;34;20;22;82
095A006;2;21;34;28;85
095A007;15;46;7;38;106
095A008;0;0;77;5;82
095A009;0;0;43;7;50
095A010;0;0;15;1;16
095A011;5;33;0;29;67
095A012;13;46;5;61;125
095A013;0;0;18;2;20
095A014;2;0;28;2;32
095A015;0;0;13;0;13
095A016;6;36;0;33;75
095A017;0;0;11;0;11
095A018;0;0;13;8;21
095A019;49;0;0;1;50
095A020;8;32;36;37;113
096A000;0;0;0;0;0
096A001;2;5;75;21;103
096A002;1;0;62;22;85
096A003A;5;0;68;4;77
096A003B;0;2;47;6;55
096A004;0;0;53;2;55
096A005;0;0;34;1;35
096A006;0;0;51;3;54
096A007;0;0;56;0;56
096A008;0;0;11;3;14
096A009;0;0;74;7;81
096A010;0;0;29;8;37
096A011;0;16;13;4;33
096A012;1;3;16;9;29
096A013;1;0;67;7;75
096A014;1;1;55;2;59
096A015;1;0;15;2;18
096A016;0;0;9;0;9
096A017;0;1;12;2;15
096A018;0;0;10;0;10
096A019;0;2;68;10;80
098A000;0;0;0;0;0
098A001;0;0;113;7;120
098A002;0;0;83;3;86
098A003;1;0;25;3;29
098A004;0;1;48;2;51
098A005;0;0;14;2;16
098A006;0;0;39;3;42
098A007;1;0;41;3;45
098A008;0;0;55;6;61
098A009;0;0;69;4;73
098A010;0;0;83;11;94
098A011;0;0;12;1;13
098A012;4;2;46;14;66
098A013;0;0;57;2;59
098A014;3;0;55;7;65
098A015;0;1;46;8;55
098A016;0;0;67;6;73
098A017;0;0;21;0;21
098A018;2;2;81;24;109
098A019;0;0;49;9;58
098A020;0;1;56;10;67
098A021;1;1;56;20;78
098A022;0;1;78;15;94
106A000;0;0;0;0;0
106A001A;6;133;1;105;245
106A001B;7;138;0;134;279
106A002A;13;132;0;65;210
106A002B;8;141;3;87;239
106A003;1;47;10;39;97
106A004;15;138;10;124;287
106A005;15;183;16;108;322
106A006;2;9;19;33;63
106A007;9;121;21;128;279
106A008;4;128;15;100;247
106A009;2;95;0;104;201
106A010;6;247;0;272;525
106A011;6;305;5;193;509
106A012;9;252;0;46;307
106A013;1;197;0;88;286
106A014;0;114;4;135;253
106A015;5;194;0;70;269
106A016;9;95;2;58;164
106A017;6;124;0;137;267
106A018;13;205;4;151;373
106A019;5;154;0;130;289
106A020;17;185;0;83;285
106A021;2;120;6;101;229
106A022;8;233;0;68;309
106A023;28;126;0;153;307
106A024;13;149;0;183;345
106A025;2;177;8;95;282
106A026;4;98;12;68;182
106A027A;8;103;11;98;220
106A027B;4;62;17;91;174
106A028;13;105;12;118;248
106A029;1;75;0;78;154
106A030;3;112;12;77;204
106A031;6;76;9;75;166
106A032;0;275;0;152;427
106A033;5;137;0;80;222
106A034;7;143;4;62;216
106A035;4;85;1;94;184
106A036;3;111;6;57;177
107A000;0;0;0;0;0
107A001;57;214;5;75;351
107A002;66;220;3;94;383
107A003;34;170;1;55;260
107A004;53;193;8;46;300
109A000;0;0;0;0;0
109A001;4;24;61;68;157
109A002;4;17;50;51;122
109A003;4;30;24;43;101
109A004;1;29;55;36;121
109A005;0;29;39;26;94
109A006;2;16;34;36;88
109A007;0;6;32;25;63
109A008;3;18;34;30;85
109A009;7;32;39;32;110
109A010;2;57;13;16;88
109A011;1;2;7;2;12
109A012;3;39;31;17;90
109A013;2;11;27;11;51
109A014;4;16;34;14;68
109A015;0;9;60;29;98
109A016;0;53;43;38;134
109A017;1;6;46;14;67
109A018;5;25;49;36;115
109A019;0;0;127;1;128
109A020A;6;6;36;18;66
109A020B;1;18;35;27;81
109A020C;2;11;17;20;50
109A021;3;56;26;31;116
109A022;0;6;28;23;57
109A023;7;103;0;58;168
109A024;16;139;3;63;221
109A025;5;27;30;33;95
109A026;7;26;65;58;156
109A027;2;7;40;22;71
109A028;2;30;41;40;113
109A029;3;6;32;8;49
109A030;0;9;33;33;75
109A031;7;39;42;42;130
109A032;2;6;90;21;119
109A033;3;14;8;11;36
109A034A;0;0;31;3;34
109A034B;0;0;43;10;53
109A035;2;52;10;23;87
109A036;0;24;21;18;63
109A037;5;35;40;38;118
109A038;6;35;37;37;115
109A039;1;22;19;28;70
109A040;0;6;21;2;29
110A000;0;0;0;0;0
110A001;0;0;14;4;18
110A002;0;25;8;19;52
110A003;0;0;28;5;33
110A004;1;27;12;10;50
110A005;0;1;6;9;16
110A006;0;0;13;5;18
110A007;1;1;25;3;30
110A008;1;2;52;28;83
110A009;1;4;49;34;88
110A010;3;141;0;69;213
110A011;12;223;1;92;328
110A012;8;236;3;92;339
110A013;6;65;37;21;129
110A014;5;186;0;82;273
110A015;8;197;12;35;252
110A016;0;45;0;14;59
110A017;0;0;71;41;112
110A018;2;21;19;17;59
110A019;3;199;0;73;275
110A020A;3;54;25;33;115
110A020B;2;74;15;52;143
110A021;2;109;30;52;193
110A022;0;0;10;5;15
110A023;4;113;24;85;226
110A024;4;82;26;16;128
110A025;1;0;46;24;71
110A026;4;145;23;85;257
111A000;0;0;0;0;0
111A001;11;167;0;73;251
111A002;9;223;0;110;342
111A003;14;275;1;60;350
111A004;3;298;7;66;374
111A005;7;143;10;38;198
111A006;12;202;8;139;361
111A007;9;181;12;97;299
111A008;13;217;21;61;312
111A009;8;138;11;50;207
111A010;19;161;5;92;277
111A011;1;16;14;17;48
111A012;0;1;23;20;44
111A013;1;1;44;19;65
111A014;1;3;49;23;76
111A015;1;15;53;28;97
111A016;0;0;11;3;14
111A017;0;4;10;10;24
111A018;1;1;15;0;17
111A019;8;84;15;31;138
111A020;0;12;15;7;34
111A021;0;0;22;8;30
111A022;4;175;1;33;213
111A023;1;0;15;4;20
111A024;2;9;52;16;79
111A025;12;192;0;74;278
111A026;10;232;10;66;318
111A027;3;24;15;10;52
111A028;4;27;30;12;73
111A029;1;77;0;7;85
111A030;14;177;9;97;297
112A000;0;0;0;0;0
112A001;2;8;67;14;91
112A002;1;236;5;45;287
112A003;5;110;13;59;187
112A004;2;104;20;32;158
112A005;11;138;16;53;218
112A006;18;285;4;108;415
112A007;1;6;30;9;46
112A008;10;0;33;5;48
112A009A;4;206;11;47;268
112A009B;3;81;24;25;133
112A010A;9;171;2;81;263
112A010B;4;175;3;105;287
112A011;4;159;14;44;221
112A012;5;52;14;20;91
112A013A;0;45;26;19;90
112A013B;0;50;26;14;90
112A014;6;303;11;40;360
112A015;11;187;0;59;257
112A016A;9;132;14;45;200
112A016B;2;78;19;29;128
112A017A;8;315;4;67;394
112A017B;3;210;7;53;273
112A018;17;414;1;98;530
112A019;15;319;0;68;402
112A020;2;157;30;36;225
112A021;3;238;7;64;312
112A022;0;3;25;11;39
112A023;0;0;19;2;21
112A024;8;247;5;71;331
112A025;9;174;7;47;237
112A026;7;308;2;59;376
112A027;1;1;3;3;8
112A028;0;3;48;13;64
112A029;12;148;15;59;234
112A030;4;144;1;29;178
112A031;1;0;19;1;21
113A000;0;0;0;0;0
113A001;4;160;9;25;198
113A002;13;327;17;67;424
113A003;0;92;19;45;156
113A004;7;178;14;59;258
113A005;3;161;13;47;224
113A006;6;297;11;40;354
113A007;11;322;0;53;386
113A008;7;145;12;29;193
113A009;11;268;20;69;368
113A010;0;60;27;17;104
113A011;0;8;11;6;25
113A012;2;1;46;2;51
113A013;0;6;35;6;47
113A014;9;286;0;58;353
113A015A;5;48;47;37;137
113A015B;0;4;24;4;32
113A016;3;282;1;46;332
113A017;1;139;30;60;230
113A018;3;36;35;30;104
113A019;7;162;4;35;208
113A020;6;159;5;59;229
113A021;0;0;50;3;53
113A022;0;0;15;5;20
113A023;4;99;26;25;154
113A024;2;4;32;2;40
114A000;0;0;0;0;0
114A001;2;61;22;59;144
114A002;7;49;32;39;127
114A003;6;3;43;23;75
114A004;7;106;4;55;172
114A005;2;7;18;4;31
114A006;1;0;5;7;13
114A007;4;25;47;25;101
114A008;19;98;26;35;178
114A009;31;217;1;97;346
114A010;2;34;25;13;74
114A011;19;178;3;90;290
114A012;1;5;23;13;42
114A013;9;29;21;49;108
114A014;0;42;33;46;121
114A015;13;49;11;15;88
114A016;3;1;34;6;44
114A017;5;25;9;25;64
114A018;8;115;15;60;198
115A000;0;0;0;0;0
115A001;1;23;9;19;52
115A002;16;177;7;84;284
115A003;5;97;33;48;183
115A004;26;317;4;107;454
115A005;13;76;52;32;173
115A006;18;173;8;72;271
115A007;13;117;9;59;198
115A008;17;266;5;88;376
115A009;9;129;9;72;219
115A010;6;106;11;22;145
115A011;10;103;28;42;183
115A012;20;231;9;61;321
115A013;21;176;9;52;258
115A014;11;188;6;67;272
115A015;3;56;31;16;106
115A016;5;79;33;79;196
115A017;8;144;1;65;218
115A018;25;175;3;56;259
115A019;12;156;15;40;223
115A020;9;216;9;99;333
115A021;4;95;0;14;113
115A022;7;87;27;33;154
115A023;0;12;27;7;46
115A024;8;160;3;32;203
115A025;14;185;14;50;263
116A000;0;0;0;0;0
116A001;5;2;46;18;71
116A002;0;0;31;7;38
116A003;1;1;69;47;118
116A004;0;0;58;35;93
116A005;6;0;48;6;60
116A006;2;0;43;17;62
116A007;2;2;48;24;76
116A008;0;0;27;7;34
116A009;0;0;73;24;97
116A010;0;0;21;0;21
116A011;1;0;51;7;59
116A012;0;1;15;5;21
116A013;1;0;56;6;63
116A014;0;0;39;15;54
116A015;1;0;52;26;79
116A016;1;1;34;14;50
116A017;1;0;23;6;30
116A018;4;6;66;42;118
116A019;3;2;56;62;123
116A020;5;3;76;52;136
116A021;0;1;16;1;18
116A022;1;0;42;23;66
116A023;2;2;39;25;68
116A024;1;0;42;5;48
116A025;0;0;27;9;36
116A026;0;0;5;4;9
116A027;1;0;22;4;27
116A028;0;0;23;8;31
116A029;5;2;44;33;84
116A030;1;4;60;36;101
116A031;0;1;31;24;56
116A032;1;2;49;22;74
116A033;0;2;38;27;67
116A034;1;0;67;45;113
116A035;0;0;34;15;49
116A036;0;3;33;11;47
116A037;0;12;14;9;35
116A038;0;0;31;6;37
116A039;0;19;4;32;55
116A040;0;0;32;13;45
116A041;4;1;57;22;84
116A042;3;2;27;13;45
116A043;0;0;19;4;23
116A044;0;1;11;2;14
116A045;0;3;27;3;33
116A046;0;0;16;1;17
116A047;1;1;57;14;73
116A048;0;0;36;18;54
116A049;0;2;50;16;68
116A050;2;0;42;13;57
116A051;0;0;53;53;106
116A052;0;0;15;2;17
117A000;0;0;0;0;0
117A001;3;6;67;35;111
117A002;6;7;52;45;110
117A003;3;14;78;26;121
117A004;1;0;65;27;93
117A005;1;0;66;13;80
117A006;0;1;26;1;28
117A007;0;0;17;3;20
117A008;0;0;12;3;15
117A009;1;1;20;1;23
117A010;1;0;38;9;48
117A011;0;0;42;8;50
117A012;1;0;51;21;73
117A013;0;0;43;12;55
117A014;0;0;48;11;59
117A015;0;0;36;5;41
117A016;0;3;33;1;37
117A017;1;0;24;5;30
118A000;0;0;0;0;0
118A001;6;7;63;31;107
118A002;3;6;67;34;110
118A003;0;0;81;29;110
118A004;0;4;47;11;62
118A005A;2;4;79;12;97
118A005B;2;2;56;13;73
118A006;2;0;57;12;71
118A007;1;1;141;12;155
118A008;2;3;64;0;69
118A009;1;0;68;12;81
118A010;0;1;77;6;84
118A011;0;2;55;13;70
118A012A;0;0;50;14;64
118A012B;1;5;41;14;61
118A013;0;1;46;4;51
118A014A;0;0;48;4;52
118A014B;0;2;52;3;57
118A015;0;0;18;7;25
118A016;1;0;58;4;63
118A017;0;0;11;0;11
118A018;0;0;1;3;4
118A019;0;0;3;5;8
118A020;2;1;1;9;13
118A021;3;6;0;17;26
118A022;2;2;4;21;29
118A023;0;2;0;0;2
118A024;0;0;2;6;8
118A025;1;0;0;10;11
118A026;0;0;1;2;3
118A027;3;4;1;11;19
118A028;4;0;1;10;15
118A029;0;0;2;3;5
124A000;0;0;0;0;0
124A001;10;161;2;65;238
124A002;3;115;0;70;188
124A003;22;158;1;86;267
124A004;3;75;1;7;86
124A005A;9;152;0;97;258
124A005B;11;178;3;131;323
124A006;6;189;0;54;249
124A007;4;266;0;41;311
124A008;1;178;0;14;193
124A009;7;177;0;19;203
124A010;5;211;2;83;301
124A011;7;167;2;41;217
124A012;8;259;0;103;370
124A013;4;193;1;28;226
124A014;3;164;0;27;194
124A015;7;136;1;45;189
124A016;14;152;1;87;254
124A017;16;231;1;105;353
124A018;9;355;1;54;419
124A019;4;124;1;108;237
124A020;6;232;0;77;315
124A021;4;109;1;64;178
124A022;2;130;0;26;158
124A023;10;161;2;73;246
124A024;7;146;2;93;248
124A025;10;161;1;106;278
124A026;3;204;2;44;253
124A027;3;246;0;16;265
124A028;1;111;1;22;135
124A029;3;58;0;38;99
125A000;0;0;0;0;0
125A001;2;141;0;105;248
125A002;9;199;1;175;384
125A003;0;62;1;51;114
125A004;2;56;0;64;122
125A005;0;24;0;28;52
125A006;3;148;0;80;231
125A007;0;12;0;10;22
125A008;0;20;0;2;22
125A009;9;168;1;184;362
125A010;1;24;0;13;38
125A011;0;159;0;136;295
125A012;0;47;0;45;92
125A013;0;0;0;3;3
125A014;0;1;1;1;3
125A015;0;115;1;37;153
125A016;0;60;0;20;80
125A017A;4;199;0;111;314
125A017B;4;165;0;124;293
125A018;2;115;0;97;214
125A019;4;141;2;99;246
125A020;0;143;0;151;294
125A021;2;142;0;124;268
125A022;0;0;0;2;2
125A023;0;85;0;84;169
125A024;0;29;0;12;41
125A025;0;84;0;26;110
125A026;1;28;0;53;82
125A027;0;6;0;21;27
125A028;0;0;0;1;1
125A029;0;0;0;5;5
125A030;0;0;0;1;1
125A031;2;123;1;80;206
125A032;0;0;0;1;1
126A000;0;0;0;0;0
126A001;0;1;3;11;15
126A002;2;2;5;25;34
126A003;3;6;1;30;40
126A004;5;4;0;14;23
126A005;3;2;3;11;19
126A006;1;37;0;9;47
126A007;3;92;0;23;118
126A008;0;40;1;5;46
126A009;0;0;0;4;4
126A010;6;0;3;16;25
126A011;0;0;0;0;0
126A012;0;0;0;2;2
126A013;0;1;0;11;12
126A014;4;0;5;5;14
126A015;0;9;0;18;27
126A016;2;1;1;1;5
126A017;6;3;1;13;23
127A000;0;0;0;0;0
127A001;2;4;2;21;29
127A002;1;6;1;35;43
127A003;7;13;0;24;44
127A004;4;8;0;60;72
127A005;5;22;0;33;60
127A006;12;26;0;58;96
127A007;5;17;3;50;75
127A008;3;18;1;31;53
127A009;4;22;0;50;76
127A010;2;32;1;20;55
127A011;5;20;0;15;40
127A012A;3;3;1;16;23
127A012B;2;6;3;22;33
127A013;0;0;2;9;11
127A014;0;0;0;0;0
127A015;0;3;0;5;8
127A016;1;1;2;6;10
127A017;0;0;0;0;0
127A018;4;18;1;29;52
127A019;0;0;0;0;0
127A020;0;0;3;17;20
127A021;0;0;0;3;3
127A022;0;1;0;10;11
127A023;1;9;0;18;28
127A024;3;13;0;17;33
127A025;0;0;2;3;5
127A026;0;3;1;7;11
127A027;1;1;0;3;5
127A028;0;3;0;14;17
127A029;0;13;0;3;16
127A030;0;1;0;1;2
127A031;0;0;0;7;7
127A032;5;8;2;36;51
127A033;3;5;2;9;19
127A034;5;18;0;69;92
127A035;5;25;0;42;72
127A036;1;1;0;10;12
127A037;0;0;0;0;0
127A038;0;0;0;0;0
127A039;0;0;0;1;1
127A040;2;15;0;2;19
127A041;0;7;0;8;15
127A042;0;5;1;6;12
127A043;0;0;0;6;6
127A044;0;10;1;6;17
127A045;0;0;0;29;29
127A046;1;20;2;17;40
127A047;1;1;1;4;7
127A048;0;0;0;5;5
127A049;0;2;0;2;4
129A000;0;0;0;0;0
129A001;8;231;6;148;393
129A002;5;136;0;58;199
129A003;11;230;3;79;323
129A004;10;221;2;66;299
129A005;12;211;1;44;268
129A006;14;258;5;110;387
130A000;0;0;0;0;0
130A001;2;1;3;28;34
130A002;3;0;3;23;29
130A003A;0;0;3;9;12
130A003B;3;1;1;8;13
130A004;2;1;0;23;26
130A005;2;0;1;3;6
130A006;2;2;0;18;22
130A007;2;1;0;7;10
130A008;4;0;8;47;59
130A009;1;0;7;16;24
130A010;1;3;3;54;61
130A011;2;9;6;32;49
130A012;0;2;1;58;61
130A013;0;0;0;22;22
130A014;0;1;0;15;16
130A015;4;0;3;34;41
130A016;0;0;4;17;21
130A017;0;0;4;6;10
130A018;0;0;4;5;9
130A019;3;0;0;29;32
130A020;2;1;0;19;22
130A021;0;0;1;19;20
130A022;0;1;5;7;13
130A023;1;6;3;16;26
130A024;0;1;1;9;11
130A025;0;2;2;9;13
130A026;0;2;0;23;25
130A027;0;1;5;4;10
130A028;0;0;0;6;6
130A029;1;1;0;3;5
130A030;0;0;0;9;9
130A031;4;2;1;37;44
130A032;0;0;5;9;14
130A033;0;2;1;9;12
130A034;0;0;0;9;9
130A035;1;5;2;10;18
130A036;3;1;1;6;11
131A000;0;0;0;0;0
131A001;0;0;1;20;21
131A002;2;2;1;14;19
131A003;0;1;0;19;20
131A004;0;0;1;17;18
131A005;2;1;0;13;16
131A006;0;3;1;13;17
131A007;1;5;3;11;20
131A008;0;3;1;6;10
131A009;2;1;2;15;20
131A010;0;0;2;31;33
131A011;1;0;4;13;18
131A012;0;1;0;31;32
131A013;0;1;2;12;15
131A014;0;0;0;25;25
131A015;0;0;0;11;11
131A016;0;0;0;24;24
131A017;0;0;0;24;24
131A018;4;1;1;23;29
131A019;6;1;0;36;43
131A020;1;4;6;36;47
131A021;3;3;2;29;37
131A022;1;2;2;19;24
131A023;0;6;1;34;41
131A024;0;0;1;22;23
131A025;2;1;2;29;34
131A026;0;0;2;29;31
131A027;2;0;0;28;30
131A028;1;3;1;34;39
131A029;2;0;2;19;23
131A030;1;0;2;31;34
131A031;2;2;0;34;38
131A032;2;1;1;38;42
131A033;1;7;2;62;72
131A034;2;9;2;39;52
131A035;5;8;1;46;60
131A036;2;4;2;36;44
131A037;0;3;3;47;53
131A038;2;2;0;36;40
131A039;4;7;0;31;42
131A040;2;6;4;52;64
131A041;3;6;2;46;57
131A042;8;6;3;79;96
131A043;2;7;4;56;69
131A044;2;3;1;28;34
131A045;5;3;3;28;39
131A046;2;1;1;13;17
131A047;1;4;2;14;21
131A048;0;3;0;12;15
131A049;0;0;0;9;9
131A050;2;2;0;11;15
131A051;0;0;2;14;16
131A052;2;2;1;17;22
131A053;5;5;0;44;54
131A054;1;3;0;15;19
131A055;0;2;0;16;18
131A056;0;14;2;57;73
131A057;2;23;6;58;89
131A058;2;12;4;24;42
131A059;1;3;2;12;18
131A060;6;1;0;22;29
131A061;1;2;5;30;38
131A062;0;4;0;15;19
131A063;3;6;1;26;36
131A064;1;5;2;24;32
131A065;0;0;1;13;14
131A066;2;1;0;22;25
131A067;2;0;1;22;25
131A068;2;2;4;16;24
131A069;1;2;0;9;12
131A070;1;2;1;23;27
131A071;0;0;1;17;18
131A072;0;0;1;26;27
131A073;0;1;0;21;22
131A074;2;2;1;34;39
131A075;1;8;2;62;73
131A076;0;2;1;26;29
131A077;5;20;4;50;79
131A078;8;21;4;64;97
131A079;4;29;2;40;75
131A080;0;31;1;50;82
131A081;3;6;2;41;52
131A082;4;2;1;67;74
131A083;5;10;5;71;91
131A084;3;4;2;28;37
131A085;0;1;0;25;26
131A086;4;5;3;20;32
131A087;0;2;0;48;50
131A088;3;10;0;44;57
131A089;2;18;3;34;57
131A090;0;3;2;43;48
131A091;2;2;1;33;38
133A000;0;0;0;0;0
133A001;1;18;7;97;123
133A002;4;9;3;92;108
133A003;7;10;2;69;88
133A004;7;2;5;60;74
133A005;3;2;1;48;54
133A006;0;1;0;44;45
133A007;1;0;4;42;47
133A008;1;1;2;28;32
133A009;0;0;2;17;19
133A010;5;8;3;46;62
133A011;2;8;3;66;79
133A012;3;5;0;45;53
133A013;2;3;4;69;78
133A014;2;2;5;51;60
133A015;4;3;5;72;84
133A016;1;3;80;72;156
133A017;8;12;81;99;200
133A018;2;18;67;59;146
133A019;4;8;67;48;127
133A020;2;5;62;49;118
133A021;0;6;64;40;110
133A022;1;9;69;33;112
133A023;1;3;60;26;90
133A024;0;0;72;18;90
133A025;2;0;57;10;69
133A026;2;11;57;31;101
133A027;2;4;70;28;104
133A028;1;0;39;18;58
133A029;1;2;52;38;93
133A030;7;0;59;18;84
133A031;0;9;70;64;143
133A032;7;5;49;49;110
133A033;3;3;80;51;137
133A034;2;6;83;62;153
133A035;7;9;54;85;155
133A036;2;8;62;60;132
133A037;1;7;69;34;111
133A038;2;4;71;52;129
133A039;1;8;65;65;139
133A040;3;7;48;52;110
133A041;2;2;72;32;108
133A042;5;12;90;53;160
133A043;1;2;60;43;106
133A044;4;2;95;90;191
133A045;6;2;94;65;167
133A046;3;11;74;53;141
133A047;3;6;69;74;152
133A048;3;4;57;46;110
133A049;4;8;59;50;121
133A050;1;10;72;55;138
133A051;4;6;75;70;155
133A052;1;9;71;51;132
133A053;2;8;59;52;121
133A054;4;14;81;50;149
133A055;2;6;74;43;125
133A056;5;0;68;46;119
133A057;2;5;42;65;114
133A058;5;7;76;53;141
133A059;1;4;73;56;134
133A060;6;0;87;79;172
133A061;4;3;85;51;143
133A062;3;0;107;55;165
133A063;2;1;99;88;190
133A064;6;2;86;61;155
133A065;2;4;109;79;194
133A066;3;5;120;63;191
133A067;2;1;78;57;138
133A068;4;4;74;60;142
133A069;3;12;67;53;135
133A070;2;4;82;72;160
133A071;3;6;65;56;130
133A072;1;9;78;61;149
133A073;3;1;66;54;124
133A074;0;1;70;45;116
133A075;1;8;68;79;156
133A076;7;8;56;64;135
133A077;2;5;69;54;130
133A078;2;5;71;70;148
133A079;8;6;98;68;180
133A080;2;8;55;52;117
133A081;4;5;68;53;130
133A082;3;10;53;59;125
133A083;5;5;102;60;172
133A084;2;5;71;54;132
133A085;2;1;78;72;153
133A086;2;10;86;77;175
133A087;5;11;72;64;152
133A088;4;4;96;77;181
133A089;9;9;107;86;211
133A090;7;18;79;82;186
133A091;4;6;71;59;140
133A092;7;4;56;66;133
133A093;3;3;68;55;129
133A094;7;1;100;47;155
133A095;1;4;74;45;124
133A096;3;2;60;34;99
133A097;1;2;61;33;97
133A098;1;2;72;50;125
133A099;0;1;55;28;84
133A100;0;0;45;28;73
133A101;1;2;53;26;82
133A102;2;1;69;32;104
133A103;1;0;71;26;98
133A104;0;0;55;33;88
133A105;1;1;75;22;99
133A106;3;7;85;45;140
133A107;2;1;54;16;73
133A108;4;1;75;54;134
133A109;3;5;63;24;95
133A110;0;0;69;37;106
133A111;6;0;45;13;64
133A112;1;1;71;20;93
133A113;5;1;46;32;84
133A114;6;1;83;41;131
133A115;0;1;80;30;111
133A116;0;4;58;35;97
133A117;0;1;59;35;95
133A118;2;0;53;25;80
133A119;1;0;72;21;94
133A120;0;0;54;18;72
133A121;2;5;42;35;84
133A122;5;1;41;22;69
133A123;0;3;68;22;93
133A124;2;0;78;33;113
133A125;0;4;107;24;135
133A126;5;1;84;23;113
133A127;0;1;71;17;89
133A128;0;7;85;36;128
133A129;0;1;73;24;98
133A130;2;1;99;40;142
133A131;1;5;77;40;123
133A132;1;0;82;10;93
133A133;0;1;91;22;114
133A134;0;0;113;33;146
133A135;2;0;62;33;97
133A136;1;1;66;26;94
133A137;1;0;74;15;90
133A138;0;0;70;12;82
133A139;1;2;57;10;70
133A140;1;0;23;13;37
133A141;1;2;90;24;117
133A142;1;2;93;13;109
133A143;0;0;73;20;93
133A144;0;0;65;7;72
133A145;4;0;87;24;115
135A000;0;0;0;0;0
135A001;2;0;56;22;80
135A002;4;1;52;25;82
135A003;0;0;86;36;122
135A004;1;0;95;41;137
135A005;1;1;81;35;118
135A006;2;1;90;17;110
135A007;0;0;105;42;147
135A008;4;1;67;44;116
135A009;3;0;102;52;157
135A010;4;0;87;30;121
135A011;3;8;59;18;88
135A012;1;1;94;7;103
135A013;0;1;22;4;27
135A014;2;0;80;24;106
135A015;2;5;73;14;94
135A016;2;0;57;26;85
135A017;5;1;87;35;128
135A018;4;2;105;39;150
135A019;3;0;101;22;126
135A020;1;0;95;17;113
135A021;3;0;87;15;105
135A022;0;4;51;31;86
135A023;3;1;56;23;83
135A024;3;1;67;42;113
135A025;1;2;52;25;80
135A026;5;3;53;25;86
135A027;7;5;86;32;130
135A028;1;0;81;17;99
135A029;1;2;67;20;90
135A030;0;0;76;12;88
135A031;3;1;83;12;99
135A032;2;0;62;12;76
135A033;0;1;76;18;95
135A034;2;0;92;4;98
135A035;0;2;50;9;61
135A036;3;3;56;4;66
136A000;0;0;0;0;0
136A001;6;4;71;63;144
136A002;5;0;82;64;151
136A003;4;7;72;59;142
136A004;3;2;79;74;158
136A005;1;1;35;19;56
136A006;4;0;77;29;110
136A007;2;0;61;19;82
136A008;5;1;55;18;79
136A009;3;0;44;72;119
136A010;3;14;81;100;198
136A011;3;5;84;135;227
136A012;7;4;88;86;185
136A013;2;5;78;51;136
136A014;5;5;91;87;188
136A015;4;4;97;91;196
136A016;0;4;40;62;106
136A017;3;11;69;116;199
136A018;7;4;77;121;209
136A019;1;12;86;105;204
136A020;2;7;71;106;186
136A021;3;4;59;44;110
136A022;2;1;40;58;101
136A023;2;0;22;30;54
136A024;14;2;67;96;179
136A025;2;8;41;57;108
136A026;2;6;81;89;178
136A027;4;13;92;104;213
136A028;5;6;63;82;156
136A029;2;1;88;14;105
136A030;3;0;95;30;128
136A031;0;0;31;9;40
136A032;2;0;54;25;81
136A033;3;4;60;50;117
136A034;4;0;68;58;130
136A035;0;2;1;1;4
136A036;4;7;81;45;137
136A037;5;11;93;100;209
136A038;6;6;71;98;181
136A039;4;4;66;82;156
136A040;1;8;72;71;152
136A041;3;4;59;59;125
136A042;1;6;44;56;107
136A043;2;6;95;45;148
136A044;5;4;37;46;92
136A045;5;10;54;82;151
136A046;5;6;49;79;139
136A047;3;4;60;65;132
136A048;6;13;71;79;169
136A049;2;10;39;49;100
136A050;5;11;71;111;198
136A051;9;9;71;87;176
136A052;1;13;74;84;172
136A053;8;2;51;81;142
136A054;7;1;65;58;131
136A055;8;5;62;73;148
136A056;10;11;75;98;194
136A057;1;8;64;61;134
136A058;3;2;52;80;137
136A059;15;15;67;54;151
136A060;8;13;80;113;214
136A061;4;10;81;103;198
136A062;2;13;102;96;213
136A063;5;9;80;79;173
136A064;1;3;58;27;89
136A065;1;4;72;21;98
136A066;3;1;100;7;111
136A067;4;8;89;92;193
136A068;1;11;81;112;205
136A069;5;10;85;117;217
136A070;4;7;82;76;169
136A071;0;2;76;56;134
136A072;0;1;71;40;112
136A073;1;2;76;50;129
136A074;3;0;58;39;100
136A075;3;7;63;87;160
136A076;2;4;50;62;118
136A077;4;11;43;70;128
136A078;11;6;53;83;153
136A079;2;10;34;61;107
136A080;2;5;75;88;170
136A081;0;2;26;24;52
136A082;3;1;63;62;129
136A083;0;0;66;20;86
137A000;0;0;0;0;0
137A001;0;0;86;45;131
137A002;1;0;87;45;133
137A003;1;0;51;19;71
137A004;2;0;63;19;84
137A005;1;0;49;11;61
137A006;0;2;55;20;77
137A007;0;0;81;35;116
137A008;0;1;108;39;148
137A009;3;1;69;41;114
137A010;3;0;69;22;94
137A011;1;1;62;23;87
137A012;2;0;69;49;120
137A013;7;3;73;54;137
137A014;5;3;74;57;139
137A015;4;7;61;85;157
137A016;1;1;78;55;135
137A017;2;0;80;53;135
137A018;10;2;91;75;178
137A019;0;3;88;40;131
137A020;2;0;90;34;126
137A021;2;0;72;25;99
137A022;0;4;73;34;111
137A023;2;0;88;25;115
137A024;2;0;57;48;107
137A025;2;1;85;50;138
137A026;2;1;60;27;90
137A027;6;0;54;56;116
137A028;3;3;72;70;148
137A029;5;2;71;41;119
137A030;3;1;72;46;122
137A031;3;2;92;53;150
137A032;0;0;99;43;142
137A033;3;0;86;61;150
137A034;3;0;82;53;138
137A035;1;0;98;24;123
137A036;2;0;75;45;122
137A037;6;0;78;46;130
137A038;7;8;58;75;148
137A039;2;1;56;63;122
137A040;2;2;76;81;161
137A041;3;3;68;106;180
137A042;10;0;77;66;153
137A043;3;5;59;89;156
137A044;5;6;68;64;143
137A045;3;6;74;89;172
137A046;2;7;68;102;179
139A000;0;0;0;0;0
139A001;0;9;79;38;126
139A002;2;11;55;54;122
139A003;1;9;76;65;151
139A004;4;9;60;47;120
139A005;6;2;78;70;156
139A006;2;5;52;57;116
139A007;3;4;78;45;130
139A008;6;2;65;52;125
139A009;4;7;65;71;147
139A010;6;15;64;78;163
139A011;1;3;64;41;109
139A012;1;4;37;56;98
139A013;4;3;65;65;137
139A014;5;15;79;59;158
139A015;4;4;94;51;153
139A016;5;4;58;86;153
139A017;2;6;78;37;123
139A018;6;7;51;47;111
139A019;5;5;89;48;147
139A020;5;1;78;74;158
139A021;2;6;85;63;156
139A022;5;5;74;70;154
139A023;1;7;63;54;125
139A024;4;3;102;67;176
139A025;3;4;70;62;139
139A026;6;6;67;67;146
139A027;2;6;68;60;136
139A028;3;13;69;57;142
139A029;0;1;60;18;79
139A030;4;9;68;45;126
139A031;5;6;75;116;202
139A032;4;4;60;53;121
139A033;8;10;74;73;165
139A034;7;8;65;60;140
139A035;7;14;67;65;153
139A036;6;5;86;64;161
139A037;2;10;81;94;187
139A038;9;10;80;78;177
139A039;6;7;73;54;140
139A040;6;13;51;73;143
139A041;3;5;70;65;143
139A042;10;7;86;66;169
139A043;4;16;87;67;174
139A044;9;6;84;77;176
139A045;2;4;69;56;131
139A046;8;14;78;66;166
139A047;10;5;80;35;130
139A048;0;0;67;23;90
139A049;0;0;57;45;102
139A050;12;9;75;47;143
139A051;2;2;55;32;91
139A052;0;4;58;41;103
139A053;1;7;60;55;123
139A054;1;8;62;87;158
139A055;4;4;80;56;144
139A056;7;7;75;60;149
139A057;1;6;54;43;104
139A058;3;13;86;82;184
139A059;3;8;73;86;170
139A060;4;9;77;60;150
139A061;4;7;49;60;120
139A062;3;5;58;53;119
139A063;5;6;52;66;129
139A064;0;12;71;71;154
139A065;1;8;56;34;99
139A066;4;13;75;59;151
139A067;4;9;87;93;193
139A068;4;17;89;105;215
139A069;2;19;111;119;251
139A070;4;15;50;45;114
139A071;7;5;46;58;116
139A072;2;8;71;76;157
139A073;7;10;63;57;137
139A074;1;14;71;62;148
139A075;2;7;62;68;139
139A076;6;12;73;97;188
139A077;2;14;78;72;166
139A078;2;13;62;85;162
139A079;1;7;48;82;138
139A080;15;17;54;83;169
139A081;3;12;85;86;186
139A082;2;13;59;40;114
139A083;7;7;72;62;148
139A084;0;4;56;25;85
139A085;2;1;87;27;117
139A086;3;2;44;47;96
139A087;3;6;50;37;96
139A088;4;4;70;41;119
139A089;1;1;76;25;103
139A090;0;2;53;22;77
139A091;3;0;48;29;80
139A092;0;1;40;25;66
139A093;4;0;60;25;89
139A094;0;3;64;33;100
139A095;5;0;78;46;129
139A096;0;0;70;57;127
139A097;2;6;58;40;106
139A098;2;1;75;29;107
139A099;5;1;63;58;127
139A100;1;0;51;18;70
139A101;0;1;42;11;54
141A000;0;0;0;0;0
141A001;1;3;90;23;117
141A002;1;0;91;27;119
141A003;0;0;44;8;52
141A004;0;1;64;20;85
141A005;0;1;103;9;113
143A001;0;2;22;4;28
148A000;0;0;0;0;0
148A001;28;264;1;73;366
148A002;43;267;1;45;356
148A003;37;233;1;66;337
148A004;36;261;0;64;361
148A005;44;312;1;70;427
148A006A;20;214;1;42;277
148A006B;10;167;0;18;195
148A007;2;108;0;33;143
148A008;15;307;0;81;403
148A009;5;168;0;64;237
148A010;28;281;0;45;354
148A011;8;229;0;40;277
148A012;31;218;0;88;337
148A013;4;38;0;9;51
148A014;34;151;0;51;236
148A015;18;99;0;30;147
148A016;18;125;0;28;171
148A017;10;202;0;42;254
148A018;17;221;0;61;299
148A019;20;180;0;79;279
148A020;25;162;1;61;249
149A000;0;0;0;0;0
149A001;9;239;0;68;316
149A002;13;320;1;60;394
149A003;18;314;0;83;415
149A004;5;74;0;48;127
149A005;6;165;0;100;271
149A006;10;143;0;56;209
149A007;22;192;0;164;378
149A008;12;206;0;62;280
149A009;0;251;0;56;307
149A010;8;335;0;58;401
149A011;8;231;0;38;277
149A012;9;448;0;59;516
149A013;21;346;0;45;412
149A014;7;64;0;23;94
149A015;3;244;0;45;292
149A016;3;148;0;71;222
149A017;10;162;0;75;247
149A018;7;227;0;66;300
150A001;7;272;0;25;304
150A002;18;266;0;39;323
150A003;18;302;0;63;383
150A004;9;270;0;80;359
150A005A;25;210;0;42;277
150A005B;4;190;0;50;244
150A006;9;274;0;35;318
150A007;11;496;0;17;524
150A008;9;547;0;64;620
150A009;4;231;0;48;283
150A010;6;189;0;21;216
150A011;2;260;0;26;288
150A012;6;243;0;36;285
150A013;10;213;0;18;241
150A014;2;449;0;6;457
150A015;15;314;0;37;366
150A016;12;579;0;89;680
150A017;14;264;0;50;328
150A018;10;390;0;81;481
150A019;14;398;1;79;492
150A020;18;390;1;80;489
150A021;17;358;0;59;434
150A022;18;384;0;55;457
150A023;7;193;0;14;214
150A024;14;268;0;67;349
150A025;13;192;0;43;248
150A026;1;90;0;8;99
150A027;0;93;0;9;102
150A028;6;283;0;23;312
150A029;8;176;0;42;226
150A030;21;234;0;24;279
150A031;11;257;0;29;297
150A032;20;444;0;109;573
150A033;9;269;0;11;289
150A034;7;245;0;45;297
150A035;13;275;0;68;356
150A036;8;271;0;42;321
151A001A;21;225;9;96;351
151A001B;23;162;2;42;229
151A002;37;309;5;65;416
151A003;26;218;1;66;311
151A004;33;421;1;79;534
151A005;8;60;0;9;77
151A006;0;5;16;31;52
151A007A;35;236;0;54;325
151A007B;34;179;1;57;271
151A007C;32;144;1;38;215
151A008;25;107;0;24;156
151A009;36;208;0;55;299
151A010;3;61;8;42;114
152A001A;0;0;39;24;63
152A001B;0;1;31;22;54
152A001C;1;1;35;21;58
152A002;0;2;23;11;36
152A003;3;19;42;52;116
152A004;5;37;29;33;104
152A005;0;0;4;5;9
152A006;0;0;20;5;25
152A007;0;6;36;20;62
152A008;0;7;46;18;71
152A009;0;0;42;49;91
152A010;0;0;5;3;8
153A001;51;347;1;66;465
153A002A;28;226;0;45;299
153A002B;11;178;0;35;224
153A003;58;374;2;94;528
153A004;21;282;2;71;376
153A005;23;265;0;57;345
153A006;20;229;0;63;312
153A007;28;166;2;69;265
153A008;45;297;2;99;443
153A009;14;210;11;75;310
153A010;22;182;16;90;310
153A011;21;165;14;60;260
153A012;17;187;7;77;288
153A013;24;173;11;90;298
153A014;17;170;23;78;288
153A015;13;188;15;86;302
153A016;18;183;22;84;307
153A017;16;172;15;101;304
153A018;15;248;13;77;353
153A019;21;260;20;86;387
153A020;24;253;26;100;403
153A021;23;242;19;91;375
153A022;25;337;7;77;446
153A023;23;282;10;66;381
153A024;16;222;5;59;302
153A025;10;281;14;87;392
153A026;18;156;29;64;267
153A027;13;203;17;66;299
153A028;15;191;4;58;268
153A029A;21;141;6;36;204
153A029B;28;119;5;36;188
153A030;46;331;0;86;463
153A031;10;76;1;14;101
153A032;19;313;6;27;365
153A033;48;308;3;76;435
153A034;24;177;9;73;283
153A035;26;298;3;66;393
153A036;25;179;9;88;301
153A037;17;225;32;119;393
154A001;1;23;10;9;43
154A002;1;8;41;6;56
154A003;0;0;8;0;8
154A004;5;13;78;26;122
154A005A;4;72;59;46;181
154A005B;3;72;23;41;139
154A006;1;0;80;47;128
154A007A;1;40;44;37;122
154A007B;8;43;26;27;104
154A007C;0;60;10;21;91
154A008A;0;6;39;20;65
154A008B;1;12;27;29;69
154A008C;1;9;19;21;50
154A009;2;24;33;23;82
154A010;2;6;46;52;106
154A011;1;12;6;9;28
155A001A;0;3;27;47;77
155A001B;1;2;26;29;58
155A002;4;6;68;61;139
155A003;1;7;66;58;132
155A004;0;9;40;52;101
155A005;0;10;47;37;94
155A006;2;2;75;68;147
155A007;1;3;36;44;84
155A008;2;3;32;25;62
155A009;3;1;53;38;95
155A010;5;0;74;66;145
155A011;2;3;73;74;152
155A012;0;10;29;40;79
155A013;5;3;59;86;153
155A014;4;5;65;72;146
155A015;2;1;45;43;91
155A016A;1;0;17;27;45
155A016B;1;0;25;25;51
155A017;3;0;75;46;124
155A018;4;5;61;37;107
155A019;0;2;39;58;99
155A020;2;12;71;58;143
155A021;1;1;70;51;123
155A022A;0;4;33;9;46
155A022B;0;3;13;11;27
155A023;0;5;13;28;46
155A024;0;2;60;41;103
155A025;0;1;25;31;57
156A001;19;168;11;50;248
156A002;26;175;14;85;300
156A003;10;166;14;71;261
156A004;24;279;0;71;374
156A005;9;67;0;2;78
156A006;1;47;0;7;55
156A007;23;213;11;101;348
156A008;67;288;0;121;476
156A009;26;219;2;72;319
156A010;21;209;13;87;330
156A011A;9;178;4;55;246
156A011B;12;185;3;56;256
156A012;26;232;20;84;362
156A013A;11;116;4;52;183
156A013B;17;104;9;43;173
156A014;18;184;6;78;286
156A015A;15;150;3;28;196
156A015B;14;145;1;49;209
156A016;14;405;4;85;508
156A017;12;5;0;6;23
156A018;14;193;9;71;287
156A019;36;201;0;92;329
156A020A;19;134;12;44;209
156A020B;12;129;17;48;206
156A021;13;187;18;72;290
156A022;20;151;6;33;210
156A023;18;120;4;53;195
156A024;30;196;5;73;304
156A025;24;174;1;56;255
156A026;0;65;0;0;65
157A001A;2;19;45;33;99
157A001B;3;23;22;50;98
157A002;3;12;70;82;167
165A000;0;0;0;0;0
165A001;2;1;60;6;69
165A002;2;1;36;2;41
165A003;0;1;7;15;23
167A000;0;0;0;0;0
167A001;1;0;71;26;98
167A002;2;1;48;28;79
167A003;11;3;42;6;62
167A004;3;2;74;15;94
167A005;3;4;52;20;79
167A006;0;1;65;25;91
167A007;1;1;53;19;74
167A008;5;1;85;23;114
167A009;1;1;51;16;69
167A010;2;1;60;28;91
167A011;1;0;52;33;86
167A012;7;6;44;11;68
167A013;2;3;99;21;125
167A014;5;2;68;18;93
167A015;3;0;69;30;102
167A016;4;1;76;30;111
167A017;0;1;49;3;53
167A018;0;2;8;1;11
167A019;0;1;43;14;58
167A020;1;2;32;8;43
167A021;0;1;60;26;87
167A022;0;1;31;9;41
167A023;1;0;49;15;65
167A024;0;0;29;19;48
167A025;0;0;10;3;13
167A026;3;2;68;32;105
167A027;0;0;73;27;100
167A028;1;0;39;13;53
167A029;1;1;50;8;60
167A030;1;0;17;8;26
167A031;0;0;31;2;33
171A000;0;0;0;0;0
171A001;23;127;0;31;181
171A002;31;98;0;151;280
171A003A;11;155;0;48;214
171A003B;10;125;2;31;168
171A004;5;161;1;41;208
171A005;30;188;0;135;353
171A006A;17;116;0;24;157
171A006B;23;205;0;55;283
171A007;6;133;0;3;142
171A008;8;117;0;36;161
171A009;48;310;0;65;423
171A010;25;134;1;59;219
171A011;30;179;0;128;337
171A012;38;181;0;50;269
171A013;13;171;0;69;253
171A014;44;357;0;79;480
171A015;10;415;1;85;511
171A016;22;118;2;99;241
171A017;14;118;0;33;165
171A018;59;248;0;112;419
171A019;18;60;4;66;148
171A020;24;182;5;100;311
171A021;15;153;2;59;229
171A022;28;219;0;86;333
171A023;9;179;0;39;227
171A024;11;277;0;39;327
171A025;9;171;0;57;237
171A026;36;227;1;99;363
171A027;42;158;3;73;276
171A028;10;82;1;94;187
171A029;16;265;0;84;365
171A030;9;145;0;35;189
171A031;24;164;0;62;250
172A000;0;0;0;0;0
172A001;25;219;0;96;340
172A002A;11;153;0;77;241
172A002B;22;191;0;31;244
172A002C;7;111;0;54;172
172A003;23;110;0;56;189
172A004;30;266;0;42;338
172A005;47;251;0;52;350
172A006;18;224;0;28;270
172A007;36;302;0;40;378
172A008;14;162;0;35;211
172A009;82;327;0;20;429
172A010;19;208;0;69;296
172A011;18;216;0;66;300
172A012;30;320;0;130;480
172A013;32;296;0;51;379
172A014;61;246;1;57;365
172A015;18;130;0;52;200
172A016;62;174;0;24;260
172A017;16;142;0;24;182
172A018;27;196;0;44;267
172A019;22;173;1;39;235
172A020;25;151;0;44;220
172A021;18;205;0;107;330
173A000;0;0;0;0;0
173A001;20;223;12;57;312
173A002;8;107;1;37;153
173A003;15;134;2;44;195
173A004;14;308;10;78;410
173A005;11;332;3;112;458
173A006;1;99;1;23;124
173A007;7;70;7;49;133
173A008;18;132;0;88;238
173A009;18;212;1;35;266
173A010;9;296;0;55;360
173A011;5;114;0;55;174
173A012;4;68;0;54;126
173A013;16;362;2;101;481
173A014;2;16;17;21;56
173A015;12;229;2;75;318
173A016;6;40;0;24;70
173A017;19;219;8;98;344
173A018;1;101;0;65;167
173A019;7;87;0;71;165
173A020A;16;95;5;52;168
173A020B;8;63;4;40;115
173A021A;10;227;0;64;301
173A021B;19;185;1;44;249
173A022A;19;222;6;58;305
173A022B;21;135;9;70;235
173A023;11;114;0;33;158
173A024;11;145;14;51;221
173A025;2;98;0;56;156
173A026;17;215;3;75;310
173A027;19;145;0;101;265
173A028;48;115;14;43;220
173A029;12;200;0;52;264
173A030;0;7;5;18;30
173A031;16;46;10;45;117
173A032;8;125;3;43;179
173A033;12;183;7;57;259
174A000;0;0;0;0;0
174A001;4;100;0;61;165
174A002;0;152;0;61;213
174A003;14;61;0;20;95
174A004;1;95;0;33;129
174A005;2;134;0;91;227
174A006;8;274;0;113;395
174A007;6;125;0;61;192
176A000;0;0;0;0;0
176A001;1;88;1;17;107
176A002;0;41;0;57;98
176A003;2;109;7;43;161
176A004;0;20;15;66;101
176A005;1;42;2;54;99
176A006;6;273;6;81;366
176A007;2;430;0;30;462
176A008;2;338;6;68;414
176A009;2;213;15;43;273
176A010;2;269;2;34;307
176A011;5;482;0;55;542
176A012;0;79;9;58;146
176A013;0;9;24;32;65
176A014;3;150;12;37;202
176A015;2;168;8;72;250
176A016;4;172;9;58;243
176A017;3;514;3;53;573
176A018;0;48;21;37;106
176A019;2;133;4;58;197
181A000;0;0;0;0;0
181A001;2;140;0;32;174
181A002;2;129;0;25;156
181A003;27;117;0;14;158
181A004;2;45;0;10;57
181A005;0;47;0;5;52
183A001;7;121;11;93;232
183A002;2;18;1;58;79
183A003;3;119;0;110;232
183A004A;1;116;1;109;227
183A004B;6;110;0;231;347
183A005;4;102;0;76;182
183A006A;10;64;7;65;146
183A006B;10;69;8;67;154
199A000;0;0;0;0;0
200C001;1;3;0;1;5
200C002;0;1;0;0;1
200C003;0;2;26;9;37
200C004;1;5;12;1;19
200C005;10;183;0;43;236
200C006;0;1;3;4;8
200C007;0;4;4;3;11
200C008;1;3;2;4;10
200C009;0;0;2;4;6
200C010;5;186;0;74;265
200C011;17;27;0;54;98
200C012;0;4;8;2;14
200C013;0;0;0;0;0
200C014A;0;1;22;3;26
200C014B;4;1;49;2;56
200C015;2;0;25;15;42
200C016;0;0;48;17;65
200C017;0;0;6;1;7
200C018;0;2;0;0;2
200C019;0;2;1;2;5
200C020;0;0;0;0;0
200C021;0;0;11;0;11
200C022;2;2;15;4;23
200C023;0;1;13;2;16
200C024;1;4;7;7;19
200C025;0;7;5;1;13
200C026;1;5;3;3;12
200C027;0;4;4;0;8
200C028;0;7;7;3;17
200C029;1;1;25;7;34
200C030;1;4;19;2;26
200C031;0;0;29;9;38
200C032;0;2;9;6;17
200C033;2;4;3;0;9
200C034;0;0;6;0;6
200C035;0;2;28;1;31
200C036;1;107;2;14;124
200C037;0;76;0;1;77
200C038;0;3;0;0;3
200C039;0;62;0;0;62
200C040;0;106;0;10;116
200C041;1;171;0;80;252
200C042;1;1;6;1;9
200C043;0;1;13;5;19
200C044;0;97;0;4;101
200C045;1;141;0;6;148
200C046;0;0;0;0;0
200C047;0;1;0;0;1
200C048A;4;1;17;4;26
200C048B;1;0;38;13;52
200C049;15;117;0;9;141
200C050;0;5;0;0;5
200C051;0;0;0;0;0
200C052;2;0;4;1;7
200C053;1;3;11;3;18
200C054;2;4;10;1;17
200C055;0;2;9;0;11
200C056;0;13;0;1;14
200C057;0;2;0;0;2
200C058;0;1;16;1;18
200C059;0;0;35;4;39
200C060;0;0;31;4;35
200C061;1;0;34;1;36
200C062;0;3;18;7;28
200C063;3;2;31;8;44
200C064;0;0;0;0;0
200C065;2;43;0;12;57
200C066;0;14;0;6;20
200C067A;0;0;13;7;20
200C067B;0;2;15;1;18
200C068;1;11;0;4;16
200C069;0;0;19;9;28
200C070;1;2;38;3;44
200C071;0;2;18;3;23
200C072;0;0;9;2;11
200C073;1;0;25;7;33
200C074;1;9;11;5;26
200C075;1;0;30;1;32
200C076;2;61;5;10;78
200C078;1;1;0;0;2
200C079;0;48;0;28;76
200C080;0;3;7;3;13
200C081;0;3;10;0;13
200C082;0;0;0;0;0
200C083;0;1;12;2;15
200C084;0;0;0;0;0
200C085;0;2;20;1;23
200C086;1;0;0;0;1
200C087;0;1;4;3;8
200C088;1;3;6;7;17
200C089;0;1;1;1;3
200C090;1;7;6;0;14
200C091;0;0;0;0;0
200C092;0;0;20;10;30
200C093;1;0;20;6;27
200C094;0;2;1;1;4
200C095;2;116;0;6;124
200C096;0;0;0;0;0
200C097;0;46;0;12;58
200C098;0;25;1;17;43
200C099;1;49;0;46;96
200C100;2;1;0;0;3
200C101;0;114;0;69;183
200C102;0;0;1;2;3
200C103;0;0;13;4;17
200C104;0;0;6;0;6
200C105;0;1;15;6;22
200C106;1;6;1;0;8
200C107;1;0;2;2;5
200C108;0;1;0;0;1
200C109;0;2;35;5;42
200C110;0;1;0;0;1
200C111;0;0;25;0;25
200C112;0;0;7;0;7
200C113;0;8;4;4;16
200C114;0;2;21;4;27
200C115;0;45;0;1;46
200C116;0;7;0;0;7
